茯苓 人参 当归 半夏 黄芩 木香 附子 芍药 柴胡 枳壳	咳嗽 目昏 呕吐 头晕 恶心 健忘 浮肿 盗汗 半身不遂 头痛
当归 石膏 羌活 麝香 杏 丁香 甘草 苍术 砂仁 香附	盗汗 自汗 潮热 头晕 半身不遂 呕吐 消瘦 气喘 鼻塞 口臭
桔梗 杏 麝香 麦冬 石膏 犀角 独活 羚羊角 生姜 陈皮	吐血 便血 崩漏 尿血 咳血 气喘 瘫痪 寒战 身重 小便不利
桔梗 羌活 五味子 当归 独活 青蒿 僵蚕 麦门冬 朱砂 附子	舌干 口苦 胁痛 咽干 疳积 头痛 小便频数 里急后重 不寐 心下悸
巴豆 羌活 独活 砂仁 桔梗 虎杖 桃仁 羚羊角 朱砂 生姜	口噤 项强 角弓反张 痫 咽喉痛 舌强 四肢拘急 湿疮 四肢强直 四肢疼痛
桔梗 砂仁 牛蒡子 紫菀 麦芽 独活 当归 桃 白芷 杏	呕吐 反胃 噎膈 寒热往来 骨痛 吞酸 小便不通 小便不利 恶寒 无名肿毒
羌活 山茱萸 麝香 泽泻 陈皮 香薷 羚羊角 独活 牛膝 甘草	心烦 五心烦热 盗汗 潮热 小便不通 崩漏 消瘦 恶露不下 小儿丹毒 胎毒
桃仁 桔梗 甘草 丹参 杏 陈皮 续断 独活 黄芪 莱菔子	瘰疬 耳聋 心悸 咽干 杨梅疮 疳积 胸闷 干呕 面色青 口臭
丁香 杏 麝香 甘草 沉香 藁本 芥子 升麻 陈皮 桑	腹痛 漏下 崩中 崩漏 胞衣不下 胎漏 咽干 流泪 口噤 胎毒
麦冬 杜仲 桑 细辛 炙甘草 羌活 砂仁 连翘 麝香 生地黄	咳嗽 耳聋 潮热 胁痛 腹满 口臭 寒热往来 烦躁 脱肛 手足厥冷
独活 麝香 白芷 苍术 麦冬 朱砂 羌活 荷叶 栀子 桔梗	腹痛 呕吐 腹冷 积滞 干呕 发黄 咳嗽 胎毒 目昏 浮肿
独活 砂仁 白豆蔻 威灵仙 白芷 杜仲 乳香 三棱 冰片 淫羊藿	咳嗽 瘰疬 少气 急惊 杨梅疮 壮热 牙痛 小便黄赤 臁疮 但热不寒
麝香 细辛 丹参 羌活 防己 橘红 肉苁蓉 萝卜 泽泻 大黄	瘰疬 臁疮 无名肿毒 脱肛 气喘 恶露不下 积滞 自汗 头重 恶心
羌活 细辛 大黄 朱砂 牛膝 藿香 栀子 川乌 硼砂 豆蔻	腹痛 难产 牙痛 浮肿 头痛 胸闷 口渴 舌苔黄 麻疹 四肢拘急
白芷 陈皮 甘草 山药 防风 地骨皮 桑 桔梗 麝香 牛黄	腹痛 咳嗽 心下痞 杨梅疮 背痛 遗尿 心悸 小便频数 腰痛 胸闷
麝香 琥珀 远志 牛膝 冰片 牛黄 阿胶 知母 黄连 杏仁	腹满 短气 干呕 目昏 咳嗽 少气 小便不利 遗尿 胸闷 不寐
陈皮 桑 桔梗 麝香 朱砂 细辛 川乌 犀角 僵蚕 白芷	神昏 谵语 烦躁 发狂 口渴 咳嗽 耳聋 无汗 头重 气喘
薄荷 杏仁 苍术 木通 丁香 山楂 防风 沉香 白芷 桔梗	咳嗽 气喘 少气 鼻干 肠鸣 多唾 目昏 舌疮 腹冷 慢惊
沉香 乳香 陈皮 桔梗 桑 黄连 羌活 菟丝子 麝香 大黄	腹痛 转筋 痫 手足厥冷 头昏 慢惊 上吐下泻 干呕 胎动不安 烦躁
细辛 川乌 黄柏 僵蚕 栀子 陈皮 巴豆 白芷 朱砂 菟丝子	吐血 鼻衄 胁痛 便血 小便不通 呕吐 呃逆 脱肛 积滞 湿疮
生姜 巴豆 桔梗 槟榔 秦艽 熟地黄 防风 神曲 细辛 远志	呕吐 恶心 腹痛 小儿呕吐 咳嗽 头昏 胃痛 胬肉攀睛 四肢疼痛 小便不通
甘草 牛黄 大黄 桑 青皮 冰片 连翘 朱砂 天麻 栀子	腹痛 呕吐 积滞 腹泻 口臭 少气 小便不利 无名肿毒 发狂 少腹痛
牛膝 桔梗 杜仲 秦艽 草乌 羌活 杏仁 没药 川芎 阿胶	腰痛 小便频数 小便不通 腹冷 腰重 浮肿 痫 头痛 口臭 骨痛
甘草 羌活 苍术 桑 白芷 荆芥 防风 牛膝 秦艽 麦冬	恶寒 头痛 恶寒发热 无汗 舌苔白 壮热 舌肿 脱肛 潮热 舌苔白腻
麝香 朱砂 白芷 大黄 薄荷 全蝎 赤石脂 栀子 川乌 紫菀	痫 慢惊 大便下血 耳聋 头晕 臁疮 牙痛 舌强 干呕 神昏
陈皮 白芷 滑石 大黄 细辛 羌活 桔梗 生姜 生地黄 玄参	小便不通 腹满 丹毒 耳聋 小便不利 发黄 骨痛 气喘 积滞 杨梅疮
槟榔 大黄 轻粉 前胡 牛黄 赤芍 升麻 杏仁 苍术 川芎	咳嗽 口渴 短气 吐血 慢惊 壮热 腹冷 咽肿 小便不通 自汗
朱砂 大黄 豆蔻 天麻 麝香 桔梗 丁香 山药 砂仁 甘草	痫 慢惊 急惊 丹毒 目昏 大便下血 牙痛 咽干 杨梅疮 心烦
防风 桔梗 黄连 白术 赤芍 白芷 甘草 生姜 天麻 款冬花	头痛 壮热 发黄 鼻衄 腰痛 尿血 干呕 产后腹痛 妊娠咳嗽 舌肿
赤芍 防风 白术 黄连 荆芥 大黄 槟榔 羌活 龙骨 甘草	烦躁 潮热 谵语 痫 腹满 瘫痪 脱肛 瘰疬 皮肤瘙痒 弄舌
木通 升麻 玄参 丁香 犀角 生姜 牛膝 知母 防风 甘草	小便不利 浮肿 臁疮 头晕 肥胖 发黄 面色青 麻疹 粉刺 腹满
吴茱萸 桑 丁香 白芍 干姜 细辛 肉桂 豆蔻 知母 甘草	白带 赤白带 瘫痪 消瘦 麻疹 足热 少气 产后血崩 胁痛 小便频数
防风 天麻 杏仁 升麻 白芍 甘草 细辛 陈皮 丁香 黄连	烦躁 壮热 大便秘结 口渴 牙龈肿痛 阴疮 畏寒 头痛 骨痛 舌干
甘草 防风 黄连 细辛 陈皮 白芍 桃 麝香 薄荷 生姜	头痛 鼻塞 目昏 胸痛 耳聋 气喘 壮热 项强 牙痛 背痛
川芎 防风 桔梗 赤芍 木通 薄荷 荆芥 白术 甘草 陈皮	头痛 鼻塞 痫 腹冷 大便秘结 丹毒 偏头痛 烦躁 浮肿 咽干
黄连 赤芍 甘草 川芎 干姜 大黄 麝香 杏仁 白术 白芍	腹痛 肠鸣 里急后重 转筋 腹泻 湿疮 头痛 遗尿 大便溏 舌疮
甘草 陈皮 黄连 白术 生姜 川芎 防风 荆芥 干姜 槟榔	吞酸 呕吐 恶心 嘈杂 呃逆 嗳气 胃痛 腰痛 头晕 疳积
甘草 大黄 黄连 防风 川芎 杏仁 白术 升麻 赤芍 黄柏	壮热 头痛 烦躁 口渴 心烦 咳嗽 无汗 目昏 大便溏 吐血
甘草 大黄 杏仁 防风 白术 黄连 生姜 桔梗 知母 川芎	咳嗽 壮热 麻疹 鼻干 气喘 鼻塞 恶心 臂痛 畏寒 心烦
甘草 白术 川芎 白芍 干姜 陈皮 防风 黄连 杏仁 生姜	恶寒 自汗 恶风 短气 身痛 身重 胎动不安 头痛 无汗 寒战
