甘草 茯苓 人参 当归 黄芩 半夏 附子 木香 芍药 柴胡	咳嗽 头痛 呕吐 目昏 恶心 腹痛 烦躁 浮肿 鼻塞 潮热
桔梗 苍术 甘草 独活 羌活 当归 大黄 牛膝 杏 白芷	心烦 潮热 五心烦热 盗汗 咽干 口苦 目昏 疳积 鼻衄 烦躁
葛根 当归 大黄 麝香 麻黄 白芷 砂仁 石膏 生地黄 甘草	呕吐 恶心 目昏 腹痛 小儿呕吐 臂痛 难产 瘰疬 短气 腹满
生地黄 当归 升麻 葛根 栀子 白芍 泽泻 甘草 细辛 独活	吐血 便血 鼻衄 咳血 尿血 口渴 阴疮 舌干 头热 心下痞
荷叶 朱砂 当归 泽泻 桔梗 藿香 苏合香 白芍 麝香 大黄	头痛 壮热 急惊 鼻塞 不寐 寒战 烦躁 偏头痛 骨痛 腰脊痛
砂仁 桔梗 生地黄 香附 细辛 白芍 薄荷 青皮 黄柏 桑白皮	头痛 壮热 鼻塞 阴疮 干呕 心下痞 舌疮 四肢疼痛 鼻衄 呕吐
陈皮 麝香 黄柏 川乌 独活 朱砂 神曲 栀子 桑白皮 细辛	腹痛 牙痛 胁痛 面色青 难产 小便不利 崩漏 小儿腹痛 弄舌 尿血
大黄 麦冬 犀角 细辛 桔梗 薄荷 桃仁 天门冬 葛根 丹参	白带 赤白带 崩漏 腹冷 头重 面色青 产后血崩 瘫痪 带状疱疹 肥胖
山药 桑 牛膝 陈皮 大黄 滑石 麦冬 生地黄 茴香 薄荷	腹痛 转筋 手足厥冷 吐血 上吐下泻 胁痛 恶露不下 产后腹痛 神昏 心下痞
连翘 朱砂 苍术 白芍 龙骨 白芷 黄连 大黄 通草 丁香	咳嗽 气喘 麻疹 脱肛 消瘦 潮热 口噤 疳积 心下悸 鼻干
防风 赤芍 丁香 知母 续断 干姜 杏仁 苍术 桃仁 黄连	自汗 盗汗 遗尿 小便频数 痫 瘰疬 潮热 慢惊 胁痛 少气
桑 泽泻 麝香 白术 白芥 薄荷 陈皮 白芍 鳖甲 远志	瘰疬 臁疮 无名肿毒 腹痛 牙痛 皮肤瘙痒 流泪 腹满 疳积 鼻衄
巴豆 大黄 细辛 苍术 犀角 黄柏 陈皮 桔梗 生姜 山药	咳嗽 干呕 反胃 短气 噎膈 腹痛 鼻干 痫 烦躁 畏寒
白芷 蒺藜 白术 桔梗 神曲 山药 黄连 牛黄 肉豆蔻 生姜	咳嗽 头痛 脱肛 杨梅疮 短气 湿疮 腹痛 气喘 舌苔黄 舌苔黄腻
黄连 麝香 桔梗 大黄 杏仁 琥珀 牛黄 麦冬 川芎 柏子仁	谵语 烦躁 耳聋 发狂 神昏 腹满 目昏 舌干 痫 胬肉攀睛
细辛 陈皮 前胡 桔梗 白芷 雄黄 乳香 麦冬 防风 生姜	口噤 痫 头痛 角弓反张 项强 腹满 舌强 腹痛 目昏 壮热
防风 大黄 干姜 桔梗 知母 生姜 桑 丁香 川芎 白芍	浮肿 小便不利 短气 腹满 大便下血 小便频数 腰重 痫 腰痛 发黄
白芍 桑 黄连 赤芍 天麻 白术 桔梗 防风 玄参 吴茱萸	烦躁 口渴 腰痛 发黄 口臭 小便不利 心下痞 面色青 鼻衄 唇肿
大黄 黄连 木通 桑 麝香 升麻 栀子 白芷 干姜 桔梗	小便不通 丹毒 腹满 大便秘结 烦躁 积滞 胎毒 口臭 发黄 身重
麝香 天麻 牛黄 朱砂 防风 白术 僵蚕 天南星 大黄 雄黄	痫 慢惊 急惊 疳积 短气 胎动不安 头重 麻疹 瘫痪 嘈杂
防风 干姜 升麻 川芎 黄连 白芍 朱砂 桑 乳香 细辛	心悸 胸闷 耳聋 头晕 多梦 食欲不振 健忘 少气 胸痛 头重
川芎 防风 阿胶 黄连 桔梗 白芍 白术 荆芥 赤芍 干姜	腰痛 胎动不安 崩中 漏下 少气 难产 胎漏 咽喉痛 短气 胞衣不下
陈皮 生姜 白术 大黄 防风 干姜 砂仁 知母 藿香 白芍	呕吐 吞酸 恶心 嘈杂 嗳气 呃逆 胃痛 臁疮 粉刺 寒战
白术 黄连 川芎 防风 杏仁 大黄 干姜 赤芍 雄黄 槟榔	腹痛 里急后重 肠鸣 腹泻 积滞 少腹痛 头昏 带状疱疹 皮肤瘙痒 目昏
川芎 白术 防风 干姜 杏仁 黄连 赤芍 前胡 生姜 陈皮	恶寒 无汗 恶风 身痛 恶寒发热 身重 舌苔白 自汗 胁痛 腹冷
