茯苓 人参 当归 半夏 黄芩 木香 附子 柴胡 枳壳 白芍	咳嗽 头晕 半身不遂 健忘 目昏 浮肿 盗汗 呕吐 心悸 恶心
当归 羌活 黄芩 甘草 砂仁 栀子 防己 红花 厚朴 杏	小便不利 瘰疬 腹满 腰痛 咳嗽 吐血 胸痛 短气 脱肛 腹泻
石膏 羌活 麝香 杏 朱砂 甘草 麻黄 香附 吴茱萸 神曲	吐血 短气 小便不通 大便秘结 腹满 干呕 恶寒 鼻衄 健忘 咳嗽
白芍 独活 附子 木香 川乌 甘草 天花粉 枳壳 栀子 升麻	反胃 呕吐 噎膈 手足厥冷 心烦 壮热 项强 舌苔白 吞酸 胬肉攀睛
朱砂 白芷 白芍 当归 生地黄 甘草 黄芩 五味子 山药 川贝母	咳嗽 头痛 咽肿 脱肛 胁痛 浮肿 嘈杂 四肢疼痛 盗汗 少气
杏 羌活 椿皮 甜瓜子 甘松 槟榔 独活 紫菀 葶苈子 山药	呕吐 恶心 吞酸 嘈杂 恶露不下 自汗 口渴 难产 善太息 但热不寒
巴豆 甘草 泽泻 侧柏叶 麻黄 紫苏叶 使君子 荷叶 麦冬 白蔹	潮热 盗汗 头痛 鼻塞 心烦 气喘 呃逆 腹泻 吐血 浮肿
山药 防己 射干 羚羊角 羌活 杏 白芍 威灵仙 白芷 麝香	腹痛 胸闷 吐血 心悸 鼻塞 腰痛 头重 心下痞 瘫痪 瘰疬
白芥 牛蒡子 莲须 羚羊角 白芍 黄连 芜荑 泽泻 独活 甘草	干呕 咳嗽 心烦 腹满 舌肿 小便不通 杨梅疮 脱肛 浮肿 鼻衄
砂仁 丹参 生地黄 香附 朱砂 三棱 山药 全蝎 青风藤 石斛	呕吐 胁痛 发黄 少气 麻疹 远视 头昏 反胃 多梦 吐血
桑 川乌 杏 白芷 杜仲 麝香 牡丹 诃子 菟丝子 防己	漏下 崩中 崩漏 胎漏 心烦 湿疮 积滞 转筋 短气 恶寒
威灵仙 秦艽 银柴胡 佛手 鹿茸 苍术 枸杞子 桑叶 羌活 紫菀	盗汗 潮热 自汗 心烦 骨痛 腹满 便血 腰重 慢惊 舌裂
生地黄 巴戟天 神曲 杏 雷丸 肉桂 莱菔子 羌活 白芷 栀子	头痛 瘰疬 壮热 无名肿毒 尿血 吞酸 呕吐 大便溏 口臭 胸闷
菟丝子 朱砂 酸枣仁 甘草 没药 川乌 巴豆 杜仲 白芷 牡丹皮	短气 少气 耳聋 丹毒 浮肿 咳嗽 自汗 崩漏 腹满 消瘦
地骨皮 石斛 阿胶 益母草 熟地黄 苍术 吴茱萸 覆盆子 砂仁 冰片	呕吐 恶心 腹冷 胃痛 面色青 壮热 嘈杂 小便频数 潮热 转筋
滑石 茵陈 栀子 豆蔻 紫菀 麦芽 槟榔 苍术 母丁香 当归	咳嗽 气喘 浮肿 腰痛 呃逆 项强 转筋 耳聋 寒战 头汗
丹参 羌活 白芷 山药 牛黄 冰片 炙甘草 薄荷 地骨皮 丁香	小便不利 浮肿 烦躁 消瘦 牙痛 鼻衄 鼻塞 口臭 难产 恶风
白芷 生地黄 桑白皮 桃仁 山药 羌活 砂仁 黄柏 葛根 羚羊角	白带 赤白带 头晕 面色青 心烦 健忘 慢惊 臁疮 吞酸 小儿遗尿
石菖蒲 泽泻 琥珀 砂仁 淫羊藿 冰片 升麻 续断 鳖甲 寒水石	难产 瘰疬 腹痛 腹冷 小便频数 杨梅疮 口渴 舌强 上吐下泻 腹满
牛黄 羌活 牛蒡 天麻 乳香 金银花 朱砂 桑 砂仁 熟地黄	吐血 咳嗽 烦躁 胎毒 畏寒 尿血 咽干 无汗 舌干 头痛
天麻 砂仁 珍珠 沉香 乌梅 泽泻 冰片 阿胶 党参 甘草	谵语 神昏 发狂 丹毒 手足厥冷 鼻衄 角弓反张 舌干 畏寒 大便溏
白芷 甘草 桃 独活 橘红 乳香 三棱 荷叶 大黄 穿山甲	腹痛 盗汗 小便不通 耳聋 无名肿毒 舌干 便血 发黄 自汗 心悸
没药 黄柏 血竭 川乌 生地黄 白术 冰片 朱砂 麝香 麦冬	腰痛 瘰疬 腹痛 呕吐 咳嗽 口渴 恶心 气喘 不寐 慢惊
桑 桃仁 丹参 杜仲 乳香 僵蚕 青皮 麝香 葛根 山楂	腰痛 瘰疬 无名肿毒 畏寒 心下痞 少气 吐血 头重 口噤 无汗
朱砂 麝香 羌活 陈皮 白芷 青皮 牛膝 防己 荷叶 豆蔻	腹痛 小便不通 烦躁 少腹痛 痫 积滞 丹毒 舌苔黄 头晕 恶寒发热
薄荷 麝香 天花粉 甘草 连翘 牡丹 青皮 羌活 冰片 炙甘草	咳嗽 目昏 自汗 舌苔白 腹满 遗尿 四肢拘急 壮热 食欲不振 骨痛
龙骨 防风 五加 熟地黄 肉苁蓉 天麻 琥珀 牛黄 甘草 沉香	咳嗽 口渴 呕吐 胁痛 大便秘结 脱肛 壮热 恶心 腰痛 气喘
麦芽 杏 桑 肉桂 桔梗 泽泻 薄荷 麦冬 地骨皮 黄柏	臁疮 腹痛 痫 急惊 耳聋 目昏 烦躁 丹毒 皮肤瘙痒 腹冷
麝香 羌活 甘草 石膏 神曲 玄参 杏 乌梅 黄柏 豆蔻	痫 咳嗽 头痛 胎毒 口臭 杨梅疮 盗汗 神昏 疳积 气喘
木通 薄荷 甘草 吴茱萸 乳香 阿胶 乌头 牛膝 藁本 桔梗	腹痛 转筋 流泪 无名肿毒 积滞 恶风 瘰疬 足热 难产 面色青
朱砂 巴豆 甘草 麝香 独活 全蝎 细辛 木瓜 豆蔻 天竺黄	痫 积滞 恶风 阴疮 舌强 胎动不安 面色青 自汗 舌干 腰重
独活 甘草 桔梗 桑 石膏 羌活 没药 乌梅 青皮 白薇	头痛 咳嗽 浮肿 心烦 腰痛 气喘 麻疹 四肢疼痛 偏头痛 遗尿
丁香 薄荷 黄连 独活 山药 沉香 赤石脂 全蝎 僵蚕 槟榔	呕吐 恶心 口渴 发黄 吞酸 小儿呕吐 脱肛 鼻塞 潮热 烦躁
朱砂 甘草 麝香 苍术 羌活 雄黄 牛膝 赤芍 川芎 乳香	腹痛 耳聋 头痛 发黄 大便秘结 咽干 痫 大便下血 瘰疬 臁疮
僵蚕 防风 苍术 甘草 槟榔 桔梗 续断 麦冬 秦艽 木通	烦躁 耳聋 目昏 面色青 慢惊 瘰疬 遗尿 便血 吐血 发黄
朱砂 丁香 防风 大黄 地骨皮 木通 沉香 杏仁 牛膝 薄荷	腹痛 牙痛 胁痛 头昏 鼻塞 胃痛 小儿口疮 湿疮 心烦 呕吐
甘草 知母 白芷 桑 羌活 白术 生姜 防风 天麻 栀子	头痛 咳嗽 目昏 恶心 四肢拘急 身重 瘫痪 鼻塞 胁痛 口渴
石膏 黄连 防风 青黛 桃 川芎 桔梗 苍术 菊花 硫黄	烦躁 咳嗽 疳积 转筋 头痛 口渴 腰痛 寒热往来 腹满 气喘
防风 吴茱萸 阿胶 丁香 升麻 柏子仁 远志 茴香 甘草 木通	心烦 五心烦热 臁疮 手足厥冷 鼻塞 鼻干 尿血 吞酸 恶心 呵欠
栀子 神曲 桔梗 陈皮 白芷 山楂 车前子 槟榔 黄连 甘草	咳嗽 小便不通 少气 口臭 潮热 壮热 头痛 恶寒 瘫痪 腹满
甘草 桔梗 黄连 乳香 神曲 紫菀 桑 山药 生地黄 肉桂	腹痛 目昏 浮肿 气喘 身重 麻疹 急惊 腰痛 腹满 心悸
麝香 天麻 朱砂 川芎 白附子 防风 青黛 桑 羌活 车前	慢惊 急惊 痫 耳聋 寒战 咽干 舌干 鼻塞 粉刺 咽喉痛
防风 黄连 甘草 芍药 藿香 丁香 陈皮 赤芍 青皮 川芎	口苦 舌干 咽干 鼻衄 腰重 吐血 恶风 耳聋 吞酸 瘫痪
大黄 甘草 桔梗 川芎 黄连 陈皮 荆芥 山药 升麻 天南星	吐血 便血 咳血 腰痛 头晕 尿血 痫 自汗 脱肛 崩漏
甘草 大黄 芍药 桔梗 川芎 知母 犀角 石膏 陈皮 麝香	瘰疬 腹满 烦躁 麻疹 气喘 壮热 发狂 臁疮 自汗 鼻衄
犀角 赤芍 甘草 干姜 芍药 牛黄 防风 麝香 桔梗 白芷	壮热 头痛 小便不通 咳嗽 嗳气 黄汗 舌疮 弄舌 上吐下泻 身重
甘草 大黄 白术 川芎 生姜 防风 黄连 陈皮 麝香 牛膝	烦躁 头痛 口渴 恶寒 壮热 身重 恶心 耳聋 小便频数 谵语
甘草 细辛 石膏 川芎 桑 知母 干姜 白术 犀角 连翘	头痛 鼻塞 壮热 短气 呕吐 发狂 鼻衄 吐血 项强 头重
陈皮 甘草 大黄 生姜 栀子 黄连 细辛 桑 桃 黄柏	烦躁 麻疹 口渴 鼻衄 鼻塞 鼻干 小便黄赤 杨梅疮 牙痛 口淡
甘草 大黄 陈皮 干姜 白术 芍药 黄连 防风 川芎 荆芥	腹痛 里急后重 肠鸣 恶心 产后腹痛 胁痛 咳嗽 咽干 带状疱疹 腹泻
甘草 芍药 防风 赤芍 干姜 白术 川芎 大黄 黄连 升麻	口噤 角弓反张 项强 急惊 神昏 疳积 头热 咽喉痛 胸闷 小便不通
杏 杏仁 甘草 桑 桔梗 干姜 白术 陈皮 前胡 槟榔	咳嗽 气喘 神昏 妊娠咳嗽 胸闷 产后血崩 消瘦 月经过多 言语错乱 健忘
甘草 防风 升麻 芍药 桔梗 石膏 黄连 细辛 大黄 陈皮	壮热 头痛 小便不利 目昏 牙痛 咽干 瘰疬 小便频数 耳聋 善怒
甘草 芍药 白术 大黄 川芎 黄连 生姜 石膏 干姜 赤芍	恶寒 无汗 身痛 恶寒发热 鼻塞 舌肿 丹毒 舌苔白 肠鸣 面色青
甘草 白术 川芎 陈皮 防风 芍药 干姜 生姜 赤芍 桔梗	自汗 恶风 胎动不安 短气 寒热往来 肠鸣 呕吐 身重 少气 背痛
