茯苓 人参 当归 半夏 附子 木香 芍药 柴胡 白芍 枳壳	盗汗 头晕 健忘 半身不遂 目昏 浮肿 恶心 心悸 白带 呕吐
黄芩 白芍 杏 芍药 羌活 白芷 甘松 牡丹皮 砂仁 五味子	腹痛 头痛 壮热 脱肛 腹泻 气喘 目昏 胸痛 小便黄赤 言语错乱
五味子 当归 黄芩 桔梗 香附 羌活 白芷 芍药 大黄 大腹皮	白带 赤白带 嗳气 牙痛 小便不利 口噤 积滞 畏寒 阴吹 心悸
五味子 杏 羌活 香附 草果 白芷 当归 白芍 黄芩 砂仁	腹痛 肠鸣 咳嗽 小便频数 潮热 小便不利 干呕 头昏 臁疮 少气
当归 黄芩 香附 麻黄 羌活 杏 白豆蔻 五味子 沉香 独活	盗汗 潮热 自汗 气喘 口噤 消瘦 烦躁 头痛 转筋 崩漏
黄芩 当归 羌活 朱砂 五味子 独活 牡丹 木瓜 肉桂 山楂	耳聋 难产 短气 项强 腹冷 口噤 痫 舌强 面色青 瘫痪
泽兰 香附 莱菔子 茴香 白附子 蜂房 麻黄 羚羊角 当归 青皮	腰痛 腹痛 背痛 转筋 四肢拘急 角弓反张 无名肿毒 胸痛 胁痛 半身不遂
菟丝子 泽兰 泽泻 牡丹皮 王不留行 竹茹 硼砂 鸡冠花 使君子 冬瓜	腹痛 寒热往来 口臭 目昏 烦躁 咽喉痛 吐血 大便秘结 脱肛 麻疹
黄芩 砂仁 白芍 杏 五味子 当归 木瓜 麝香 桔梗 半夏	腹痛 呃逆 呕吐 胁痛 遗尿 四肢疼痛 少气 胃痛 发狂 阴痒
羌活 黄芩 甘草 桑枝 女贞 细辛 桃 芍药 生地黄 槐花	腹痛 积滞 干呕 腰痛 耳聋 呕吐 鼻衄 胁痛 臁疮 半身不遂
羌活 芍药 白芷 甘草 木香 麝香 黄连 桂枝 当归 桔梗	呕吐 胸闷 背痛 小儿呕吐 杨梅疮 咳嗽 恶心 自汗 手足厥冷 胸痛
白芷 丹参 独活 羌活 山药 草果 木瓜 桔梗 全蝎 杏	浮肿 骨痛 胁痛 短气 气喘 吐血 发黄 寒热往来 瘰疬 崩漏
沉香 干漆 桃仁 羚羊角 石榴皮 丹参 牡丹皮 羌活 杏 青皮	舌干 口苦 心烦 咽干 腹泻 发黄 难产 干呕 脱肛 腰痛
陈皮 冬葵子 麝香 使君子 酸枣仁 桃仁 山楂 羌活 麦芽 黄芩	反胃 噎膈 腹痛 转筋 胃痛 臁疮 胁痛 恶寒 吐血 杨梅疮
桔梗 麝香 小茴香 茴香 甘草 砂仁 丹参 党参 桑叶 柏子仁	小便不利 烦躁 心烦 脱肛 吐血 恶心 自汗 气喘 少气 心下痞
泽泻 生地黄 独活 丹参 丁香 沉香 升麻 赭石 乌头 白芷	呕吐 恶心 吞酸 小便不利 浮肿 壮热 气喘 四肢拘急 瘰疬 嗳气
丁香 杏 木通 陈皮 麝香 甘草 淫羊藿 桔梗 三棱 酸枣仁	腹痛 痫 产后腹痛 头痛 流泪 肠鸣 咽干 恶心 咳嗽 小便不利
羌活 石菖蒲 杏 桃仁 葛根 山药 麦冬 木瓜 白芷 肉桂	咳嗽 潮热 瘰疬 舌肿 壮热 小儿口疮 遗尿 鼻干 寒热往来 胎漏
黄芩 麝香 朱砂 全蝎 桑 生地黄 犀角 麻黄 车前 紫菀	目昏 恶心 发黄 腰痛 口渴 浮肿 面色青 心烦 疳积 头重
麝香 紫菀 牛膝 肉苁蓉 白芷 砂仁 独活 五加 杜仲 冰片	咳嗽 呕吐 腹满 头昏 腰痛 遗尿 鼻塞 头重 小便不通 头热
大黄 没药 陈皮 羌活 石膏 黄芩 三棱 泽泻 牛黄 薤白	瘰疬 目昏 急惊 胸闷 鼻塞 壮热 健忘 心悸 粉刺 拳毛倒睫
吴茱萸 冰片 沉香 薄荷 炙甘草 五加 石斛 地骨皮 牵牛子 姜黄	吐血 便血 咳血 鼻衄 崩漏 腹冷 咽干 腹痛 胞衣不下 小便频数
杜仲 栀子 羚羊角 桑 神曲 橘红 杏 茴香 大黄 生地黄	口噤 角弓反张 气喘 舌强 项强 难产 胎毒 口渴 口淡 腰痛
朱砂 麦冬 牵牛 乌头 牡丹 熟地黄 白芷 连翘 瓜蒌 石膏	吐血 腹痛 无名肿毒 鼻衄 心悸 舌苔白 胞衣不下 食欲不振 咳嗽 积滞
丁香 地骨皮 桑 远志 桃仁 白术 麦冬 鹿茸 淡竹 党参	腹痛 盗汗 心烦 气喘 头晕 寒热往来 腹冷 呵欠 肠鸣 少气
桑 牛膝 白芷 桔梗 没药 独活 麝香 黄芩 乌药 苍术	小便不利 浮肿 小便频数 疳积 肠鸣 嘈杂 谵语 咽干 四肢疼痛 痫
牛膝 麝香 砂仁 黄芩 生地黄 紫苏子 陈皮 苍术 桑 麦冬	腹满 短气 咳嗽 恶心 腰痛 潮热 杨梅疮 心悸 无名肿毒 足热
大黄 黄芩 杏 诃子 白芷 山药 豆蔻 羌活 甘草 连翘	咳嗽 耳聋 气喘 不寐 小便不通 手足厥冷 瘫痪 疳积 呕吐 短气
黄连 朱砂 牛黄 甘草 龙骨 犀角 薄荷 黄柏 滑石 制草乌	痫 自汗 潮热 壮热 胸闷 积滞 吞酸 头晕 口噤 呕吐
龙骨 麻黄 丁香 羌活 琥珀 青黛 蝉蜕 藿香 天竺黄 杏仁	壮热 烦躁 鼻衄 瘫痪 尿血 小便不通 干呕 喷嚏 潮热 杨梅疮
防风 紫菀 麝香 丁香 薄荷 牛黄 天门冬 川芎 石膏 桃	小便不通 呕吐 烦躁 少气 转筋 咽干 大便下血 鼻干 面色青 嘈杂
天麻 远志 龙胆 桔梗 地骨皮 苍术 朱砂 石膏 枳实 升麻	瘰疬 痫 腰痛 口渴 潮热 大便秘结 头晕 谵语 舌干 恶心
川乌 巴豆 陈皮 栀子 肉豆蔻 黄柏 豆蔻 羌活 黄芩 泽泻	痫 难产 吞酸 短气 腹满 口臭 肠鸣 尿血 疳积 浮肿
黄芩 细辛 朱砂 杏 桑 黄连 独活 黄柏 白芷 乳香	咳嗽 小便不通 腰痛 大便秘结 头痛 气喘 疳积 吐血 面色青 腹满
石膏 甘草 麝香 大黄 苍术 杏 独活 桃 黄连 桔梗	烦躁 腹满 口渴 神昏 心烦 呕吐 短气 吞酸 咽干 畏寒
黄芩 甘草 麝香 黄连 大黄 羌活 巴豆 杏 细辛 栀子	烦躁 麻疹 口渴 口臭 嘈杂 短气 浮肿 小便不通 腰痛 畏寒
琥珀 麻黄 冰片 郁金 龙骨 大黄 生姜 玄参 芦荟 桔梗	心烦 五心烦热 丹毒 身痛 咳嗽 胎动不安 浮肿 崩中 头痛 足颤
大黄 细辛 竹茹 黄芩 薄荷 羌活 杜仲 连翘 阿胶 神曲	崩中 漏下 吐血 崩漏 大便下血 胎漏 心下痞 疳积 腹痛 噎膈
黄连 羌活 石膏 麻黄 甘草 麝香 知母 朱砂 桃 青皮	壮热 头痛 口苦 干呕 气喘 自汗 背痛 浮肿 舌干 上吐下泻
防风 朱砂 豆蔻 僵蚕 藜 天麻 滑石 麝香 连翘 黄芩	咳嗽 烦躁 丹毒 牙痛 腰重 心烦 咽喉痛 里急后重 自汗 臁疮
桔梗 黄芩 黄柏 乳香 大黄 杏 槟榔 麝香 牡丹 僵蚕	咳嗽 腹痛 慢惊 腰痛 头昏 少气 恶风 多梦 腰膝无力 自汗
防风 轻粉 麻黄 石膏 甘草 天麻 龙骨 薄荷 桔梗 桃仁	咳嗽 臁疮 无名肿毒 吐血 鼻塞 恶心 心悸 嘈杂 鼻干 急惊
雄黄 朱砂 泽泻 巴豆 黄连 僵蚕 桑 赤芍 麻黄 白术	瘰疬 痫 麻疹 流泪 健忘 口臭 转筋 疳积 恶心 谵语
黄连 甘草 黄芩 薄荷 杏仁 陈皮 赤芍 全蝎 桃仁 桔梗	口渴 咽干 头痛 耳聋 牙痛 小便不利 头晕 畏寒 麻疹 干呕
防风 麻黄 大黄 地骨皮 薄荷 川芎 雄黄 天麻 甘草 杏仁	烦躁 痫 呕吐 胁痛 壮热 心烦 项强 盗汗 神昏 转筋
防风 甘草 杏仁 黄连 黄芩 桑 陈皮 白术 青皮 菊花	头痛 咳嗽 胁痛 转筋 多唾 浮肿 发黄 短气 弄舌 胃痛
石膏 黄芩 巴豆 甘草 大黄 白芷 防风 栀子 黄连 玄参	头痛 壮热 恶风 头昏 鼻衄 慢惊 腹痛 耳聋 脱肛 里急后重
白附子 天麻 丁香 赤芍 防风 天南星 干姜 大黄 桔梗 麝香	慢惊 急惊 壮热 短气 呃逆 大便下血 小儿口疮 舌强 头痛 咽喉痛
黄芩 甘草 桔梗 黄连 陈皮 栀子 苍术 杏 朱砂 麝香	头痛 麻疹 大便秘结 皮肤瘙痒 心烦 小便不利 痫 潮热 鼻塞 杨梅疮
黄芩 黄连 桔梗 细辛 防风 川芎 甘草 陈皮 荆芥 白术	神昏 谵语 发狂 胎毒 痫 瘰疬 干呕 头重 胬肉攀睛 急惊
陈皮 雄黄 防风 黄芩 玄参 甘草 槟榔 桔梗 川芎 生姜	头痛 牙痛 鼻塞 湿疮 腰痛 口噤 无名肿毒 目昏 呕吐 心烦
陈皮 甘草 干姜 泽泻 防风 桔梗 黄连 川芎 前胡 肉桂	呕吐 恶心 鼻塞 舌苔黄 丹毒 咳血 项强 耳聋 小便不利 心下痞
甘草 防风 大黄 赤芍 桔梗 干姜 荆芥 天南星 麻黄 前胡	头痛 壮热 身重 头晕 潮热 寒热往来 面色青 麻疹 鼻塞 口渴
甘草 干姜 大黄 黄芩 槟榔 白术 陈皮 川芎 生姜 苍术	腹痛 里急后重 手足厥冷 头痛 慢惊 腹冷 四肢拘急 腹泻 肠鸣 口渴
杏仁 杏 麻黄 甘草 石膏 桑 陈皮 大黄 麦冬 紫菀	咳嗽 气喘 烦躁 肠鸣 手足厥冷 弄舌 发狂 牙龈肿痛 鼻塞 麻疹
甘草 大黄 干姜 黄连 知母 生姜 槟榔 荆芥 桔梗 杏仁	咳嗽 腹满 寒热往来 小便不通 头重 自汗 项强 腹痛 便血 寒战
甘草 黄芩 干姜 白术 防风 川芎 荆芥 陈皮 生姜 桔梗	恶寒 恶寒发热 身痛 无汗 身重 发黄 头痛 恶风 口酸 口噤
甘草 川芎 黄芩 升麻 防风 黄连 木通 陈皮 栀子 大黄	头痛 鼻塞 壮热 丹毒 烦躁 胁痛 脱肛 面色青 流泪 恶心
甘草 白术 赤芍 前胡 黄芩 川芎 防风 生姜 大黄 干姜	恶风 恶寒 无汗 自汗 项强 壮热 鼻塞 胸痛 大便秘结 心烦
甘草 白术 川芎 防风 陈皮 干姜 生姜 赤芍 前胡 黄芩	自汗 呕吐 胎动不安 短气 身重 少气 吞酸 心下痞 肠鸣 转筋
