甘草 茯苓 人参 半夏 附子 木香 柴胡 枳壳 麻黄 厚朴	咳嗽 呕吐 恶心 目昏 头晕 盗汗 半身不遂 健忘 心悸 浮肿
独活 五味子 砂仁 当归 朱砂 石膏 甘草 香附 白芷 雷丸	腹痛 肠鸣 手足厥冷 浮肿 口臭 便血 头痛 健忘 瘫痪 崩漏
甘草 当归 香附 黄芩 茴香 五味子 石膏 麻黄 葶苈子 神曲	呕吐 腹痛 烦躁 浮肿 腹冷 自汗 牙痛 臂痛 腰重 食欲不振
杏 五味子 甘草 香附 白芍 枳壳 麝香 沉香 附子 羌活	腹痛 腹冷 呕吐 烦躁 便血 腰痛 尿血 积滞 恶心 脱肛
川乌 神曲 细辛 紫苏叶 黄芩 生地黄 甘草 当归 香薷 白芷	呕吐 反胃 心烦 流泪 噎膈 恶寒 咳嗽 多唾 瘰疬 呃逆
杏 五味子 细辛 竹茹 天南星 苍术 侧柏叶 羚羊角 白芍 浮萍	恶心 呕吐 吞酸 嘈杂 疳积 舌苔白 小便不通 便血 喷嚏 消瘦
杏 五味子 广藿香 桔梗 陈皮 诃子 苍术 紫菀 独活 香附	舌干 口苦 咽干 小便频数 口噤 反胃 半身不遂 疳积 舌苔黄 四肢拘急
当归 黄芩 杏 川贝母 白芷 苍术 菟丝子 黄柏 肉豆蔻 白扁豆	头痛 干呕 气喘 壮热 噎膈 发黄 半身不遂 耳聋 偏头痛 流泪
山楂 荷叶 赤石脂 砂仁 贯众 当归 独活 海风藤 杏 桔梗	潮热 盗汗 自汗 便血 杨梅疮 口噤 少气 瘰疬 项强 积滞
当归 黄芩 琥珀 丹参 羌活 麦冬 山药 藿香 甘草 川乌	呕吐 腹痛 转筋 耳聋 胎毒 手足厥冷 脱肛 四肢疼痛 咳血 舌强
当归 桔梗 熟地黄 秦艽 香附 白芷 石膏 地骨皮 甘草 巴豆霜	咳嗽 气喘 鼻塞 盗汗 积滞 恶露不下 遗尿 口渴 干呕 脱肛
五味子 杏 当归 桔梗 麝香 硼砂 防己 皂矾 羚羊角 川乌	吐血 转筋 胁痛 小便不利 目昏 舌强 难产 舌干 短气 吞酸
山药 川贝母 连翘 羚羊角 杏 细辛 泽兰 钩藤 肉苁蓉 苏木	腹痛 头痛 牙痛 干呕 自汗 腹满 恶风 面色青 浮肿 丹毒
炙甘草 白芷 金银花 当归 皂荚 五味子 鹿茸 甘草 藜芦 远志	咳嗽 目昏 烦躁 吐血 短气 瘫痪 咽干 丹毒 心下痞 小儿发热
麝香 山药 桔梗 茴香 菟丝子 三棱 细辛 酸枣仁 陈皮 当归	漏下 崩中 崩漏 难产 痫 少气 背痛 尿血 急惊 胎漏
桑 桔梗 山药 牡丹皮 当归 生地黄 紫菀 高良姜 赤石脂 沉香	咳嗽 腹痛 脱肛 胁痛 腹满 头痛 胃痛 消瘦 背痛 自汗
朱砂 山楂 麝香 皂荚 滑石 生地黄 杏 薄荷 牡丹 全蝎	咳嗽 四肢疼痛 气喘 瘰疬 呃逆 潮热 干呕 盗汗 腹满 发黄
牛膝 龙骨 薄荷 远志 橘红 升麻 当归 芫花 秦艽 白芷	腹痛 短气 气喘 瘰疬 手足厥冷 小便黄赤 目昏 不寐 消瘦 肠鸣
五味子 杜仲 朱砂 栀子 乌药 桃仁 当归 沉香 泽泻 红花	小便不利 耳聋 咳嗽 寒热往来 短气 畏寒 发狂 无汗 干呕 痫
乳香 槟榔 杏 桑 桃仁 菊花 白芍 石斛 白芷 沉香	自汗 恶风 咳嗽 项强 少气 目昏 积滞 头痛 腰痛 肠鸣
当归 桃 桑 秦艽 豆蔻 杜仲 白芍 桃仁 僵蚕 北沙参	头痛 腰痛 咳嗽 骨痛 慢惊 丹毒 神昏 浮肿 恶风 咽干
麝香 薄荷 牛膝 桑白皮 沉香 当归 朱砂 山药 知母 豆蔻	小便不通 自汗 心烦 腹满 短气 恶风 烦躁 盗汗 疳积 潮热
牛黄 朱砂 神曲 陈皮 牛膝 珍珠 青皮 紫草 泽泻 没药	痫 头痛 烦躁 呕吐 心下痞 心悸 牙痛 呵欠 短气 口渴
丁香 乳香 赤芍 冰片 红花 乌梅 没药 牛黄 淡竹 天麻	瘰疬 痫 小便频数 脱肛 阴疮 噎膈 气喘 四肢疼痛 恶心 杨梅疮
天麻 麝香 细辛 地龙 乌梅 赤芍 牵牛 白芷 甘草 白芍	咳嗽 心烦 呕吐 腹冷 短气 神昏 发黄 四肢拘急 恶寒 不孕
桔梗 青皮 白芷 远志 防风 黄芩 牵牛 天竺黄 小茴香 石斛	腹痛 浮肿 耳聋 鼻衄 胎动不安 自汗 大便秘结 心悸 胁痛 咳嗽
丁香 轻粉 当归 天麻 天竺黄 乌头 槟榔 雄黄 菊花 薄荷	瘰疬 臁疮 无名肿毒 杨梅疮 瘫痪 心烦 呕吐 骨痛 湿疮 鼻塞
赤芍 冰片 黄连 当归 槟榔 牛黄 木通 旋覆花 泽泻 石膏	咳嗽 气喘 浮肿 发黄 盗汗 尿血 口臭 急惊 烦躁 大便秘结
荆芥 杏 朱砂 桃 当归 前胡 白芷 远志 知母 牡丹	咳嗽 少气 咽干 耳聋 腹痛 壮热 里急后重 小儿呕吐 腰脊痛 吞酸
杏 巴豆 丁香 麝香 当归 苍术 黄芩 石膏 朱砂 大黄	痫 身重 腹泻 头痛 发黄 寒热往来 小便频数 呃逆 里急后重 鼻塞
陈皮 牛蒡子 细辛 山药 白芷 桑 车前子 青皮 杏 枳实	小便不利 浮肿 恶寒 呕吐 痫 头重 干呕 瘫痪 崩漏 大便溏
防风 当归 桑 陈皮 白芍 秦艽 黄柏 大黄 青皮 白芷	呕吐 腹痛 恶心 头昏 口臭 里急后重 鼻衄 气喘 健忘 小便不通
当归 乳香 防风 川芎 荆芥 天麻 木通 生姜 白芍 赤芍	吐血 痫 烦躁 咳嗽 头痛 浮肿 寒热往来 慢惊 小便不通 目昏
黄芩 大黄 当归 川芎 车前 枳实 桑 丁香 朱砂 栀子	吐血 鼻衄 便血 咳血 口噤 崩漏 胎漏 阴疮 发狂 腰脊痛
当归 陈皮 大黄 白芍 细辛 杜仲 朱砂 川芎 地骨皮 黄芩	腰痛 腹痛 肠鸣 气喘 小便不通 不寐 浮肿 杨梅疮 骨痛 崩中
当归 黄芩 黄连 桔梗 桑 大黄 栀子 石膏 朱砂 陈皮	谵语 神昏 烦躁 发狂 舌肿 牙龈肿痛 足痛 转筋 腹冷 骨痛
当归 滑石 白芷 大黄 陈皮 桔梗 生姜 乳香 石膏 朱砂	小便不通 牙痛 大便秘结 短气 口臭 鼻塞 面色青 胎毒 无汗 多唾
五味子 当归 防风 丁香 远志 陈皮 白芍 杏仁 牛膝 肉桂	头晕 胸闷 腰痛 胁痛 心悸 积滞 小便不利 大便下血 胸痛 崩漏
桔梗 当归 黄连 白芍 黄芩 黄柏 滑石 连翘 杏 薄荷	腹痛 里急后重 肠鸣 杨梅疮 小便不利 麻疹 难产 身痛 吐血 产后腹痛
当归 黄连 大黄 苍术 桑 桔梗 巴豆 荆芥 地骨皮 黄芩	心烦 五心烦热 消瘦 胁痛 小便不通 带状疱疹 便血 牙痛 尿血 呵欠
当归 麦冬 防风 黄芩 白芍 桃 川芎 桔梗 大黄 杏	口渴 烦躁 壮热 头痛 大便秘结 转筋 盗汗 口噤 咽喉痛 耳内流脓
陈皮 黄芩 当归 白芷 大黄 杏 防风 五味子 生姜 桔梗	口噤 角弓反张 手足厥冷 自汗 无汗 上吐下泻 头痛 面色青 大便秘结 咽干
麝香 白附子 天南星 朱砂 僵蚕 雄黄 天麻 全蝎 黄连 防风	慢惊 急惊 痫 湿疮 皮肤瘙痒 遗尿 寒热往来 噎膈 积滞 气喘
当归 杏仁 赤芍 防风 黄芩 白术 桑 大黄 桔梗 石膏	麻疹 烦躁 丹毒 口臭 慢惊 瘰疬 潮热 咳嗽 寒热往来 小儿丹毒
陈皮 细辛 杏仁 生姜 大黄 黄芩 黄连 川芎 麦冬 当归	头痛 鼻塞 无汗 鼻干 胁痛 咽干 腹满 咽喉痛 臁疮 流泪
黄芩 杏 石膏 当归 升麻 大黄 杏仁 栀子 芍药 犀角	头痛 壮热 鼻塞 腹满 寒热往来 里急后重 烦躁 恶寒 心烦 唇肿
当归 芍药 大黄 黄连 黄芩 川芎 白术 防风 知母 白芍	白带 赤白带 臂痛 鼻衄 唇肿 产后腹痛 痄腮 嘈杂 牙龈出血 耳聋
芍药 干姜 当归 白术 防风 川芎 赤芍 槟榔 陈皮 丁香	头痛 腹满 口渴 耳聋 恶心 流泪 反胃 小便不通 气喘 痄腮
黄芩 芍药 大黄 干姜 白术 黄连 赤芍 升麻 川芎 石膏	壮热 腹痛 恶心 身重 转筋 流泪 无汗 消瘦 寒战 寒热往来
白术 当归 川芎 防风 芍药 白芍 干姜 陈皮 生姜 黄芩	恶寒 胎动不安 自汗 恶寒发热 身痛 恶风 无汗 项强 身重 四肢疼痛
