甘草 茯苓 人参 半夏 黄芩 附子 木香 芍药 柴胡 枳壳	咳嗽 目昏 恶心 头晕 浮肿 呕吐 盗汗 半身不遂 潮热 口苦
甘草 丁香 五味子 香附 石膏 羌活 黄芩 半夏 苦参 小茴香	头痛 呕吐 干呕 腰痛 恶寒 呃逆 烦躁 半身不遂 难产 浮肿
杏 五味子 当归 香附 白芍 羌活 黄芩 芍药 甘草 沉香	呕吐 心烦 难产 头痛 胁痛 舌强 咽喉痛 疳积 烦躁 头重
杏 独活 五味子 侧柏叶 黄芩 苦参 朱砂 甘草 白芍 泽兰	少气 牙痛 脱肛 瘰疬 里急后重 呃逆 腹痛 目昏 流泪 骨痛
石膏 独活 甘草 当归 杏 麝香 女贞子 熟地黄 僵蚕 白芷	烦躁 腹冷 潮热 心烦 干呕 口苦 咽干 难产 里急后重 咳嗽
五味子 杏 香附 甘草 陈皮 当归 石膏 芍药 白芷 柴胡	呕吐 恶心 疳积 痫 头痛 牙痛 嗳气 烦躁 胁痛 上吐下泻
黄芩 桑 香附 朱砂 当归 生地黄 砂仁 牛黄 麝香 白芷	腹满 短气 腹痛 小便不利 耳聋 头晕 肠鸣 自汗 畏寒 瘰疬
杏 泽泻 独活 瓜蒂 川乌 白芍 苍术 神曲 马勃 厚朴花	咳嗽 脱肛 头痛 小便不利 心烦 小便频数 腹泻 舌苔黄 臁疮 骨痛
杏 独活 川贝母 白芍 麝香 海藻 羚羊角 香附 山楂 白附子	口噤 角弓反张 自汗 项强 骨痛 干呕 四肢强直 急惊 胞衣不下 胁痛
紫菀 香附 生地黄 桑 硼砂 使君子 神曲 陈皮 川乌 大枣	吐血 便血 尿血 咳血 大便溏 头汗 舌强 潮热 口苦 胬肉攀睛
麝香 朱砂 白扁豆 黄连 川乌 没药 益智 紫草茸 菟丝子 肉桂	呕吐 腹痛 少气 耳聋 小儿呕吐 腰重 里急后重 遗尿 但热不寒 多唾
五味子 陈皮 防己 川乌 僵蚕 葛根 肉豆蔻 牛膝 细辛 诃子	头痛 烦躁 壮热 短气 皮肤瘙痒 耳聋 小便不利 鼻塞 口淡 腹痛
当归 车前子 石决明 川乌 杏 菟丝子 车前 白茅根 丁香 白芍	反胃 噎膈 壮热 发黄 烦躁 咳嗽 小便不利 手足厥冷 气喘 呃逆
香附 沉香 黄连 龙骨 陈皮 白芍 杏 赤芍 连翘 酸枣仁	咳嗽 呕吐 心下痞 瘰疬 咽干 盗汗 浮肿 腹冷 壮热 耳聋
牛黄 丁香 升麻 鹿茸 冰片 犀角 薄荷 桑寄生 吴茱萸 前胡	崩中 漏下 崩漏 口臭 小便频数 胎漏 头重 舌肿 慢惊 消瘦
牛黄 草豆蔻 菊花 石斛 天麻 赤芍 丁香 乌头 藜芦 砂仁	腹痛 咽干 遗尿 背痛 头痛 崩漏 小便黄赤 转筋 积滞 手足厥冷
麝香 杏 连翘 白芷 牡丹 香附 豆蔻 山楂 栀子 麦冬	头痛 壮热 臁疮 大便秘结 崩漏 转筋 口噤 畏寒 盗汗 咽干
黄柏 独活 石菖蒲 槟榔 川乌 肉桂 豆蔻 泽泻 白芷 白芍	咳嗽 气喘 浮肿 干呕 腰重 神昏 发狂 短气 瘫痪 发黄
当归 砂仁 陈皮 麝香 杏 白芷 苍术 川芎 桔梗 菊花	腹痛 胁痛 肠鸣 胞衣不下 大便下血 里急后重 流泪 浮肿 湿疮 小儿口疮
桑 麝香 丁香 前胡 僵蚕 苦杏仁 藿香 砂仁 白术 牡丹	咳嗽 头痛 口渴 目昏 项强 盗汗 口臭 呕吐 湿疮 胎毒
苍术 当归 神曲 独活 朱砂 防风 薄荷 麝香 五味子 川芎	心悸 胸闷 头晕 舌干 健忘 胸痛 小便不利 食欲不振 口苦 不寐
山药 当归 栀子 麝香 薄荷 青皮 朱砂 玄参 乳香 沉香	痫 慢惊 疳积 舌肿 牙痛 头痛 头重 拳毛倒睫 唇肿 杨梅疮
麝香 当归 天麻 龙胆 川芎 防风 沉香 黄连 青黛 没药	吐血 鼻衄 舌苔白 胁痛 臂痛 咽干 臁疮 崩漏 多唾 积滞
山楂 大黄 薄荷 琥珀 陈皮 山药 青皮 荆芥 细辛 五味子	耳聋 腹满 小便不通 胁痛 短气 口苦 腹痛 瘫痪 项强 肠鸣
苍术 龙骨 当归 天麻 牡蛎 没药 草乌 乳香 鳖甲 天竺黄	瘰疬 无名肿毒 臁疮 吐血 胁痛 头痛 寒战 发黄 背冷 舌卷
五味子 朱砂 当归 细辛 神曲 黄柏 苍术 桑 龙骨 丹参	头痛 壮热 慢惊 鼻塞 腰痛 四肢疼痛 瘫痪 小便黄赤 阴疮 少气
当归 山药 没药 大黄 杜仲 防己 连翘 白芍 牛膝 槟榔	盗汗 自汗 潮热 目昏 身重 恶寒 呵欠 少气 小便频数 发狂
杜仲 牡蛎 牛膝 僵蚕 丁香 肉桂 乌头 猪苓 陈皮 苍术	腰痛 壮热 杨梅疮 瘰疬 呕吐 吐血 食欲不振 耳聋 产后腰痛 舌疮
朱砂 麝香 白附子 全蝎 天南星 牛膝 僵蚕 远志 当归 羚羊角	慢惊 痫 急惊 少气 积滞 耳聋 不孕 恶露不下 漏下 小便不通
细辛 牛膝 香附 麝香 栀子 杜仲 桑 黄连 巴豆 白芷	痫 烦躁 头痛 鼻衄 项强 积滞 多梦 崩漏 潮热 杨梅疮
丁香 藿香 桔梗 当归 熟地黄 防风 豆蔻 川芎 白术 沉香	腹痛 大便秘结 瘰疬 杨梅疮 寒热往来 干呕 小便不通 腰脊痛 鼻衄 遗尿
当归 天麻 黄连 知母 桔梗 白芍 乳香 苍术 雄黄 大黄	谵语 神昏 口渴 发狂 发黄 腹满 咳嗽 积滞 胎毒 舌苔黄腻
大黄 白芷 桑 当归 薄荷 荆芥 香附 生地黄 槟榔 白芍	小便不利 浮肿 牙痛 小便不通 腹痛 口渴 烦躁 鼻衄 急惊 大便下血
麝香 当归 麦冬 黄连 豆蔻 大黄 栀子 黄柏 槟榔 桔梗	腹痛 转筋 瘰疬 烦躁 鼻衄 手足厥冷 口渴 难产 脱肛 流泪
黄连 大黄 防风 桑 细辛 当归 黄柏 陈皮 肉桂 栀子	烦躁 口渴 咳嗽 舌干 积滞 口臭 牙痛 疳积 小便不通 无汗
生姜 当归 吴茱萸 枳实 桔梗 白芍 白芷 川芎 防风 干姜	心烦 五心烦热 口苦 胎毒 心下痞 小便不通 臁疮 头热 目昏 小便黄赤
当归 白芷 大黄 防风 槟榔 川芎 干姜 细辛 地骨皮 桃	腹痛 里急后重 肠鸣 麻疹 崩漏 尿血 恶风 脱肛 急惊 难产
升麻 石膏 当归 大黄 知母 防风 赤芍 干姜 犀角 生姜	壮热 头痛 身重 鼻干 痫 舌强 牙龈肿痛 瘰疬 浮肿 腹冷
防风 陈皮 当归 桔梗 川芎 白芷 干姜 犀角 丁香 黄连	鼻塞 头痛 头昏 项强 恶心 目昏 咽干 发黄 臂痛 积滞
陈皮 槟榔 黄连 当归 生姜 香附 丁香 大黄 砂仁 青皮	吞酸 恶心 呕吐 嘈杂 胃痛 嗳气 舌干 弄舌 消瘦 喉痒
赤芍 木通 黄连 升麻 大黄 防风 川芎 当归 白芍 桃	麻疹 小便不通 丹毒 目昏 烦躁 牙痛 呕吐 小便频数 小儿丹毒 口臭
当归 大黄 防风 干姜 白芷 生姜 陈皮 黄连 白术 升麻	恶寒 无汗 恶寒发热 身痛 便血 恶风 角弓反张 恶心 舌卷 小便频数
杏仁 杏 桔梗 桑 大黄 石膏 陈皮 知母 当归 生姜	咳嗽 气喘 远视 妊娠咳嗽 唇肿 肥胖 心烦 经行腹痛 消瘦 多梦
川芎 白术 当归 大黄 黄连 干姜 白芍 阿胶 荆芥 防风	白带 赤白带 鼻干 大便下血 便血 痫 粉刺 胬肉攀睛 小儿丹毒 杨梅疮
白术 当归 防风 川芎 干姜 陈皮 白芍 生姜 桔梗 黄连	自汗 恶风 胎动不安 短气 恶寒 面色青 身重 寒热往来 身痛 畏寒
