甘草 当归 白芍 人参 白术 柴胡 茯苓 川芎 黄芩 陈皮	自汗 潮热 头痛 恶寒 心烦 口渴 盗汗 口苦 烦躁 寒热往来
桃 桃仁 当归 川芎 红花 甘草 香附 赤芍 白芷 川乌	腹痛 白带 头痛 赤白带 半身不遂 腰痛 胁痛 难产 心烦 浮肿
甘草 生姜 半夏 人参 干姜 茯苓 当归 附子 白术 芍药	呕吐 短气 腹满 自汗 少气 腹痛 恶寒 干呕 恶风 手足厥冷
桑 桑白皮 甘草 杏 杏仁 茯苓 桔梗 郁李仁 郁李 槟榔	咳嗽 浮肿 气喘 小便不利 咽干 鼻塞 小便不通 口渴 舌干 腹满
甘草 防风 荆芥 川芎 桔梗 羌活 黄芩 大黄 连翘 当归	壮热 头痛 麻疹 鼻塞 恶寒 杨梅疮 无汗 丹毒 谵语 烦躁
牡丹 牡丹皮 当归 牛膝 五加 五加皮 杜仲 茯苓 防风 甘草	腰痛 吐血 白带 四肢麻木 盗汗 目昏 半身不遂 心烦 耳聋 不孕
茴香 木香 豆蔻 干姜 丁香 巴豆 三棱 肉豆蔻 附子 陈皮	腹痛 呕吐 恶心 肠鸣 积滞 腹冷 吞酸 腹满 浮肿 反胃
杏仁 杏 甘草 茯苓 人参 半夏 前胡 紫菀 五味子 桔梗	咳嗽 短气 气喘 头痛 鼻塞 吐血 呕吐 无汗 恶寒 多唾
防风 甘草 细辛 羌活 川芎 独活 麻黄 附子 菊花 当归	头痛 目昏 口噤 鼻塞 项强 四肢拘急 角弓反张 恶风 流泪 神昏
甘草 柴胡 鳖甲 人参 大黄 茯苓 秦艽 沙参 黄芩 犀角	壮热 心烦 烦躁 盗汗 咳嗽 痫 潮热 头痛 四肢疼痛 发黄
甘草 黄芩 黄连 大黄 栀子 冰片 连翘 黄柏 郁金 薄荷	烦躁 瘰疬 大便秘结 吐血 口渴 谵语 神昏 胸闷 鼻衄 发狂
当归 大黄 黄连 赤芍 芍药 使君子 木香 白芷 胡黄连 桃	瘰疬 腹痛 疳积 无名肿毒 消瘦 吐血 难产 骨痛 积滞 潮热
甘草 黄芩 升麻 石膏 连翘 竹叶 芍药 赤芍 犀角 葛根	头痛 壮热 烦躁 口渴 心烦 咳嗽 恶寒 麻疹 瘰疬 咽干
木香 厚朴 甘草 槟榔 陈皮 白术 香附 枳壳 青皮 神曲	腹痛 呕吐 吞酸 恶心 嘈杂 肠鸣 嗳气 里急后重 积滞 腹满
白术 茯苓 甘草 泽泻 山药 白芍 当归 党参 陈皮 砂仁	腹痛 小便不利 胎动不安 白带 浮肿 头晕 赤白带 崩漏 食欲不振 口渴
当归 甘草 麦门冬 车前 芍药 人参 茯苓 车前子 黄连 黄芩	吐血 小便不通 腹痛 便血 鼻衄 崩中 小便不利 尿血 漏下 大便下血
乳香 麝香 没药 丁香 木香 雄黄 朱砂 沉香 血竭 杏	瘰疬 臁疮 无名肿毒 牙痛 瘫痪 腹痛 白带 半身不遂 赤白带 湿疮
茯苓 远志 当归 五味子 人参 牛膝 菟丝子 山药 杜仲 肉苁蓉	健忘 心悸 盗汗 头晕 耳聋 多梦 自汗 腰痛 小便频数 烦躁
麝香 朱砂 附子 白附子 天麻 僵蚕 雄黄 牛黄 全蝎 天南星	痫 慢惊 急惊 壮热 咳嗽 神昏 口噤 烦躁 角弓反张 潮热
甘草 陈皮 茯苓 藿香 半夏 厚朴 木香 白术 人参 丁香	呕吐 恶心 头痛 腹痛 转筋 恶寒 目昏 咳嗽 吞酸 反胃
