角色0 ： 豆蔻 肉豆蔻 诃子 木香 附子 人参 白术 茯苓 当归 厚朴  角色1 ： 干姜 胡椒 丁香 生姜 厚朴 附子 甘草 肉桂 高良姜 茴香  角色2 ： 丁香 白豆蔻 人参 沉香 白术 甘草 木香 砂仁 豆蔻 藿香  角色3 ： 青皮 槟榔 三棱 木香 陈皮 莪术 枳壳 巴豆 牵牛 半夏	呕吐 肠鸣 恶心 腹痛 吞酸 反胃 积滞 腹满 腹冷 口苦
角色0 ： 茯苓 土茯苓 当归 白鲜皮 金银花 防风 甘草 川芎 木瓜 木通  角色1 ： 苦参 威灵仙 荆芥 白芷 何首乌 苍耳 防风 苍术 川芎 苍耳子  角色2 ： 白芷 当归 白及 木鳖子 乳香 白蔹 没药 赤芍 蓖麻 杏仁  角色3 ： 当归 大黄 黄柏 独活 羌活 蜈蚣 三棱 全蝎 川乌 肉桂	杨梅疮 瘰疬 头痛 臁疮 皮肤瘙痒 咳嗽 麻疹 瘫痪 阴疮 骨痛
角色0 ： 阿胶 艾叶 当归 甘草 地榆 蒲黄 黄芩 干姜 人参 白术  角色1 ： 龙骨 赤石脂 干姜 黄连 当归 禹余粮 牡蛎 地榆 厚朴 附子  角色2 ： 人参 五味子 续断 当归 附子 牛膝 茯苓 鹿茸 磁石 石斛  角色3 ： 芍药 白芍 川芎 熟地黄 当归 白术 甘草 茯苓 香附 人参	腹痛 白带 崩中 赤白带 漏下 胎动不安 崩漏 胎漏 吐血 少气
角色0 ： 桑 桑白皮 五味子 桔梗 知母 阿胶 紫菀 陈皮 甘草 人参  角色1 ： 半夏 杏 杏仁 生姜 桔梗 甘草 细辛 陈皮 橘红 厚朴  角色2 ： 麻黄 甘草 杏仁 杏 石膏 黄芩 桂枝 干姜 大枣 当归  角色3 ： 杏 杏仁 茯苓 人参 甘草 白术 防己 紫苏子 枳实 柴胡	咳嗽 气喘 鼻塞 无汗 咳痰 头昏 喉痒 恶风 寒热往来 咽干
角色0 ： 连翘 薄荷 荆芥 桔梗 甘草 防风 石膏 栀子 黄芩 大黄  角色1 ： 黄连 黄芩 黄柏 大黄 栀子 甘草 苦参 秦皮 郁金 姜黄  角色2 ： 当归 赤芍 川芎 芍药 甘草 白芷 防风 羌活 生地黄 升麻  角色3 ： 枳壳 当归 木香 白芍 槟榔 陈皮 青皮 厚朴 甘草 地榆	里急后重 腹痛 大便秘结 烦躁 便血 口苦 牙痛 大便下血 舌干 脱肛
角色0 ： 白及 当归 乳香 五倍子 没药 白芷 黄柏 黄连 白蔹 血竭  角色1 ： 雄黄 斑蝥 藜芦 藜 蜈蚣 巴豆 麝香 全蝎 朱砂 附子  角色2 ： 草乌 川乌 川芎 防风 苍术 细辛 白芷 麻黄 荆芥 当归  角色3 ： 草乌 半夏 川乌 甘草 细辛 大黄 僵蚕 白芷 天南星 葱白	瘰疬 头痛 耳聋 吐血 无名肿毒 瘫痪 牙痛 半身不遂 臁疮 恶心
角色0 ： 当归 川芎 延胡索 红花 莪术 香附 三棱 赤芍 五灵脂 芍药  角色1 ： 莪术 槟榔 三棱 山楂 青皮 大黄 枳实 神曲 厚朴 枳壳  角色2 ： 沉香 木香 香附 乌药 姜黄 枳壳 砂仁 郁金 柴胡 甘草  角色3 ： 香附 甘草 附子 益智 砂仁 莪术 三棱 木香 陈皮 甘松	腹痛 呕吐 恶心 吞酸 嘈杂 胃痛 嗳气 胁痛 积滞 胸闷
角色0 ： 麦门冬 桑 天门冬 甘草 桔梗 人参 桑白皮 茯苓 地骨皮 阿胶  角色1 ： 前胡 茯苓 枳壳 桑 旋覆花 槟榔 半夏 大黄 大腹皮 木通  角色2 ： 紫菀 杏仁 杏 款冬花 百合 百部 麻黄 甘草 马兜铃 白前  角色3 ： 五味子 人参 甘草 细辛 干姜 白术 半夏 茯苓 白石英 当归	咳嗽 气喘 短气 多唾 妊娠咳嗽 咳血 食欲不振 面色白 胎漏 骨痛
角色0 ： 益母草 当归 香附 川芎 白芍 茯苓 白术 黄芩 阿胶 木香  角色1 ： 冬瓜 蒲公英 金银花 桃 大黄 桃仁 车前 赤芍 薏苡仁 板蓝根  角色2 ： 夏枯草 昆布 海藻 连翘 当归 柴胡 甘草 桔梗 陈皮 漏芦  角色3 ： 丹参 郁金 黄芪 川芎 三七 麦冬 山楂 泽泻 白术 赤芍	瘰疬 腹痛 胸闷 浮肿 胁痛 白带 心悸 肥胖 舌苔黄 不孕
角色0 ： 白芷 丁香 没药 当归 乳香 玄参 肉桂 乌药 木香 羌活  角色1 ： 血竭 乳香 冰片 没药 儿茶 轻粉 麝香 龙骨 大黄 赤石脂  角色2 ： 巴豆 三棱 木香 莪术 干漆 大黄 五灵脂 丁香 芫花 槟榔  角色3 ： 乳香 雄黄 没药 麝香 朱砂 蟾酥 轻粉 蜈蚣 血竭 全蝎	瘰疬 臁疮 无名肿毒 腹痛 湿疮 杨梅疮 牙痛 积滞 反胃 胎毒
角色0 ： 吴茱萸 干姜 黄连 桔梗 人参 厚朴 巴豆 茯苓 皂荚 柴胡  角色1 ： 郁李 郁李仁 槟榔 桑 防己 茯苓 木通 木香 枳壳 泽漆  角色2 ： 甘遂 杏仁 杏 巴豆 芫花 大戟 大黄 芍药 泽泻 牛黄  角色3 ： 牵牛 牵牛子 大黄 槟榔 木香 当归 滑石 甘草 三棱 瞿麦	浮肿 小便不利 气喘 小便不通 腹满 咳嗽 大便秘结 痫 积滞 难产
角色0 ： 乌药 香附 川芎 当归 白芷 甘草 白术 枳壳 防风 白芍  角色1 ： 附子 吴茱萸 干姜 硫黄 木香 肉桂 当归 桃 桃仁 杜仲  角色2 ： 茴香 小茴香 川楝子 木香 当归 甘草 胡芦巴 杜仲 苍术 山药  角色3 ： 沉香 附子 牛膝 木香 肉苁蓉 巴戟天 丁香 茯苓 补骨脂 五味子	腹冷 白带 腹痛 赤白带 腰痛 转筋 手足厥冷 目昏 面色青 气喘
角色0 ： 独活 白术 防风 细辛 当归 附子 人参 麻黄 茯苓 甘草  角色1 ： 防己 甘草 芍药 防风 麻黄 石膏 黄芩 秦艽 葛根 人参  角色2 ： 乌头 秦艽 山茱萸 干姜 牛膝 杜仲 细辛 远志 防风 石斛  角色3 ： 桑 桑寄生 当归 甘草 茯苓 白芍 续断 川芎 狗脊 人参	口噤 恶风 耳聋 腰痛 角弓反张 半身不遂 项强 短气 舌强 背痛
角色0 ： 黄连 胡黄连 柴胡 鳖甲 知母 地骨皮 人参 银柴胡 甘草 秦艽  角色1 ： 莲子 莲子心 大黄 薄荷 黄芩 玄参 桔梗 柴胡 滑石 黄连  角色2 ： 龙胆 甘草 黄芩 栀子 柴胡 大黄 当归 芦荟 黄连 木通  角色3 ： 青蒿 黄芩 香附 麦芽 防风 苍术 赤小豆 枳壳 郁金 柴胡	潮热 心烦 盗汗 口渴 五心烦热 烦躁 口苦 耳聋 咳嗽 胁痛
角色0 ： 炙甘草 甘草 当归 人参 炮姜 白术 白芍 川芎 茯苓 肉桂  角色1 ： 陈皮 半夏 茯苓 白术 甘草 黄连 枳实 生姜 人参 竹茹  角色2 ： 香附 枳壳 桔梗 当归 麦冬 木香 远志 丹参 陈皮 甘草  角色3 ： 羌活 防风 泽泻 苍术 柴胡 升麻 甘草 独活 黄柏 神曲	恶寒 呕吐 心下痞 身重 头痛 自汗 呃逆 舌苔白 大便溏 肠鸣
角色0 ： 麦冬 沙参 百合 天冬 桑 百部 桑叶 阿胶 款冬花 梨  角色1 ： 瓜蒌 甘草 半夏 桔梗 黄芩 陈皮 茯苓 枳实 枳壳 黄连  角色2 ： 知母 地骨皮 桑 甘草 当归 桑白皮 人参 茯苓 桔梗 白术  角色3 ： 使君子 黄连 芜荑 槟榔 木香 芦荟 胡黄连 青皮 雷丸 陈皮	咳嗽 潮热 疳积 消瘦 咽干 口渴 咳血 气喘 吐血 鼻干
角色0 ： 神曲 麦芽 山楂 半夏 香附 枳实 茯苓 陈皮 黄连 白术  角色1 ： 苍术 厚朴 甘草 陈皮 藿香 枳壳 半夏 香附 槟榔 草果  角色2 ： 砂仁 木香 白术 甘草 茯苓 陈皮 人参 白芍 党参 干姜  角色3 ： 当归 人参 干姜 甘草 泽兰 柏子仁 白芷 芜荑 防风 细辛	呕吐 腹痛 吞酸 恶心 嘈杂 嗳气 反胃 腹满 噎膈 积滞
角色0 ： 朱砂 雄黄 巴豆 麝香 半夏 轻粉 牛黄 郁金 巴豆霜 滑石  角色1 ： 附子 白附子 麝香 全蝎 天麻 僵蚕 天南星 蜈蚣 朱砂 青黛  角色2 ： 麝香 牛黄 犀角 天南星 附子 麻黄 白附子 防风 天麻 羚羊角  角色3 ： 薄荷 琥珀 神曲 朱砂 天竺黄 钩藤 僵蚕 甘草 槟榔 藿香	慢惊 痫 急惊 神昏 口噤 角弓反张 舌强 四肢拘急 项强 壮热
角色0 ： 栀子 黄芩 茵陈 大黄 甘草 枳实 柴胡 茵陈蒿 郁金 秦艽  角色1 ： 木通 滑石 车前 瞿麦 车前子 甘草 茯苓 冬葵 当归 冬葵子  角色2 ： 木香 升麻 沉香 甘草 青木香 大黄 连翘 麝香 玄参 犀角  角色3 ： 泽泻 猪苓 茯苓 白术 陈皮 苍术 黄连 甘草 防己 厚朴	小便不通 小便不利 发黄 尿血 口渴 难产 小便黄赤 头汗 烦躁 咽肿
角色0 ： 牛蒡 牛蒡子 桔梗 升麻 甘草 荆芥 防风 紫草 连翘 前胡  角色1 ： 木通 蝉蜕 荆芥 防风 连翘 当归 甘草 黄芩 赤芍 柴胡  角色2 ： 黄芩 连翘 玄参 桔梗 天花粉 甘草 黄连 金银花 赤芍 薄荷  角色3 ： 川芎 白芷 羌活 薄荷 防风 荆芥 甘草 细辛 石膏 菊花	头痛 麻疹 鼻塞 丹毒 壮热 谵语 烦躁 口渴 咽干 头昏
角色0 ： 杏仁 杏 桑 薄荷 桔梗 麻黄 苦杏仁 枇杷 甘草 枇杷叶  角色1 ： 连翘 薄荷 甘草 牛蒡 荆芥 桔梗 竹叶 牛蒡子 金银花 桑叶  角色2 ： 前胡 枳壳 桔梗 甘草 茯苓 半夏 陈皮 人参 葛根 黄芩  角色3 ： 防风 羌活 柴胡 川芎 荆芥 甘草 独活 白芷 葛根 黄芩	咳嗽 头痛 恶寒 无汗 鼻塞 麻疹 恶寒发热 壮热 口渴 身痛
角色0 ： 橘红 甘草 半夏 茯苓 白术 石菖蒲 枳实 人参 厚朴 黄连  角色1 ： 赤芍 芍药 枳壳 木香 人参 当归 槟榔 桔梗 白术 茯苓  角色2 ： 蔓荆子 羌活 细辛 藁本 川芎 防风 柴胡 甘草 黄芩 升麻  角色3 ： 牡丹 牡丹皮 当归 芍药 白芍 延胡索 牛膝 干姜 川芎 生地黄	头痛 目昏 腹痛 胁痛 舌干 恶寒 壮热 口苦 寒热往来 盗汗
角色0 ： 青黛 薄荷 硼砂 冰片 甘草 荷叶 黄连 黄柏 雄黄 玄明粉  角色1 ： 钩藤 大黄 蛇蜕 牛黄 石膏 黄芩 升麻 甘草 龙齿 蜂房  角色2 ： 石膏 寒水石 滑石 甘草 大黄 牡蛎 赤石脂 黄芩 龙骨 紫石英  角色3 ： 牛黄 朱砂 犀角 麝香 人参 龙齿 远志 麦门冬 甘草 防风	痫 壮热 烦躁 发狂 舌干 心烦 舌疮 舌肿 湿疮 言语错乱
角色0 ： 丹参 远志 柏子仁 当归 玄参 石菖蒲 甘草 酸枣仁 五味子 珍珠  角色1 ： 麦冬 天冬 人参 当归 山药 五味子 茯苓 牛膝 白术 杜仲  角色2 ： 菊花 黄芩 薄荷 金银花 野菊花 甘草 夏枯草 地龙 白芷 竹叶  角色3 ： 沙参 麦冬 甘草 白芍 北沙参 天花粉 石斛 太子参 茯苓 知母	口渴 心悸 咽干 头痛 自汗 心烦 头晕 健忘 不寐 鼻塞
角色0 ： 生地黄 当归 甘草 白芍 芍药 麦门冬 川芎 蒲黄 阿胶 天门冬  角色1 ： 麦冬 玄参 甘草 知母 木通 石膏 连翘 桔梗 石斛 白芍  角色2 ： 柴胡 地骨皮 人参 鳖甲 茯苓 秦艽 知母 枳壳 芍药 桑  角色3 ： 黄连 黄芩 犀角 甘草 栀子 升麻 桔梗 竹茹 地榆 葛根	吐血 烦躁 心烦 潮热 鼻衄 咽干 谵语 口渴 盗汗 五心烦热
角色0 ： 麻黄 桂枝 甘草 防风 白芍 羌活 麻黄根 川芎 当归 白芷  角色1 ： 鳖甲 柴胡 秦艽 木香 槟榔 甘草 知母 常山 乌梅 枳壳  角色2 ： 干姜 细辛 吴茱萸 芍药 当归 附子 甘草 乌头 大黄 川乌  角色3 ： 人参 白术 茯苓 桔梗 甘草 紫菀 牡蛎 前胡 芍药 麦冬	盗汗 恶寒 自汗 壮热 无汗 口苦 恶风 头痛 潮热 寒热往来
角色0 ： 防风 羚羊角 枳壳 独活 羌活 甘草 酸枣仁 菊花 人参 白鲜皮  角色1 ： 升麻 黄芩 柴胡 大黄 栀子 知母 麻黄 牡丹 荆芥 鳖甲  角色2 ： 丹参 苦参 人参 沙参 玄参 附子 干姜 大黄 细辛 秦艽  角色3 ： 杏仁 杏 芍药 麻黄 甘草 当归 赤芍 黄芩 石膏 葛根	头痛 壮热 项强 鼻塞 四肢拘急 恶风 目昏 神昏 烦躁 头重
角色0 ： 川乌 桂枝 乳香 麻黄 没药 威灵仙 当归 羌活 马钱 牛膝  角色1 ： 牛膝 杜仲 木瓜 当归 防风 羌活 川芎 独活 续断 苍术  角色2 ： 菟丝子 蛇床子 远志 虎骨 牛膝 鹿茸 续断 龙骨 甘草 木鳖子  角色3 ： 淫羊藿 补骨脂 鹿茸 枸杞子 肉苁蓉 人参 当归 菟丝子 肉桂 附子	腰痛 半身不遂 四肢麻木 白带 关节疼痛 赤白带 骨痛 不孕 瘫痪 足痛
角色0 ： 朱砂 雄黄 丁香 麝香 木香 蟾酥 牛黄 沉香 犀角 天麻  角色1 ： 黄连 麝香 胡黄连 青黛 芦荟 熊胆 朱砂 牛黄 使君子 雄黄  角色2 ： 白矾 半夏 天南星 猪牙皂 皂荚 生姜 薄荷 甘草 寒水石 附子  角色3 ： 硫黄 附子 杏 杏仁 细辛 轻粉 桃 当归 巴豆 麝香	壮热 痫 慢惊 口臭 瘰疬 急惊 口噤 疳积 手足厥冷 鼻痒
角色0 ： 桑 杏 黄芩 杏仁 桔梗 甘草 麦冬 前胡 枳壳 知母  角色1 ： 神曲 香附 黄连 山楂 萝卜 枳实 连翘 木香 陈皮 麦芽  角色2 ： 芥子 白芥 白芥子 甘草 柴胡 茯苓 当归 白术 白芍 人参  角色3 ： 川贝母 半夏 紫苏子 瓜蒌 杏仁 法半夏 石膏 苦杏仁 杏 麻黄	咳嗽 咽干 气喘 口渴 烦躁 胸闷 咳痰 腹满 舌干 发狂
角色0 ： 乳香 没药 甘草 白芷 当归 防风 金银花 穿山甲 皂角刺 陈皮  角色1 ： 蜈蚣 红花 僵蚕 荆芥 大黄 黄芩 连翘 苏木 全蝎 防风  角色2 ： 威灵仙 当归 独活 香附 乌药 麻黄 赤芍 羌活 防风 白芷  角色3 ： 钩藤 天麻 白芍 菊花 僵蚕 桑 牛膝 橘红 黄芩 全蝎	头痛 瘰疬 无名肿毒 发狂 恶心 舌干 头晕 偏头痛 呃逆 烦躁
角色0 ： 白薇 当归 没药 川芎 白术 藁本 茯苓 白芍 香附 甘草  角色1 ： 桑 桑螵蛸 菟丝子 龙骨 杜仲 牡蛎 山药 芡实 茯苓 肉苁蓉  角色2 ： 藜 蒺藜 防风 附子 甘草 羌活 当归 枳壳 菊花 独活  角色3 ： 鹿角 鹿角胶 鹿角霜 茯苓 枸杞子 人参 熟地黄 当归 五味子 甘草	腹痛 腰痛 自汗 盗汗 心烦 白带 浮肿 崩漏 遗尿 头晕
角色0 ： 木香 陈皮 大腹皮 甘草 青皮 茯苓 槟榔 草果 人参 白术  角色1 ： 白术 人参 附子 干姜 甘草 茯苓 山药 地锦草 川芎 百草霜  角色2 ： 当归 肉桂 白芍 芍药 川芎 甘草 茯苓 人参 荆芥 土茯苓  角色3 ： 桔梗 白芷 陈皮 半夏 枳壳 川芎 苍术 厚朴 茯苓 甘草	腹痛 呕吐 浮肿 恶寒 头痛 手足厥冷 自汗 难产 身痛 肠鸣
角色0 ： 桃 桃仁 大黄 当归 甘草 鳖甲 木香 枳壳 茯苓 槟榔  角色1 ： 豆蔻 草豆蔻 厚朴 白术 木香 生姜 吴茱萸 高良姜 附子 人参  角色2 ： 红花 当归 川芎 羌活 生地黄 白芍 防风 甘草 黄芩 牛膝  角色3 ： 升麻 柴胡 人参 甘草 当归 苍术 陈皮 黄柏 白术 青皮	腹痛 短气 恶寒 自汗 脱肛 面色青 转筋 呵欠 肠鸣 大便秘结
角色0 ： 何首乌 菟丝子 熟地黄 枸杞子 黄芪 山药 制何首乌 当归 淫羊藿 杜仲  角色1 ： 益智 益智仁 茯苓 人参 白术 甘草 当归 厚朴 石菖蒲 陈皮  角色2 ： 桃 桃仁 红花 川芎 当归 赤芍 丹参 泽兰 香附 甘草  角色3 ： 白芷 桂枝 肉桂 附子 乌药 薄荷 天麻 穿山甲 木香 当归	腹痛 头晕 畏寒 遗尿 健忘 鼻衄 小便频数 胸闷 胸痛 腹满
角色0 ： 红花 血竭 当归 三七 乳香 白芷 苏木 栀子 延胡索 莪术  角色1 ： 巴豆 木香 丁香 杏 杏仁 沉香 巴豆霜 百草霜 豆蔻 朱砂  角色2 ： 赭石 代赭石 朱砂 五灵脂 乳香 赤石脂 附子 麝香 硫黄 胡椒  角色3 ： 薄荷 樟脑 丁香 细辛 冰片 白芷 干姜 川乌 陈皮 独活	腹痛 骨痛 恶心 呕吐 难产 吐血 腹满 腰痛 白带 胞衣不下
角色0 ： 麦门冬 甘草 人参 茯苓 地骨皮 羚羊角 防风 芦根 百合 竹茹  角色1 ： 升麻 大黄 犀角 玄参 甘草 木通 黄芩 栀子 枳壳 射干  角色2 ： 芍药 赤芍 甘草 黄芩 柴胡 前胡 枳实 半夏 桔梗 旋覆花  角色3 ： 石膏 葛根 知母 黄芩 甘草 柴胡 麻黄 栀子 葱白 生姜	壮热 头痛 烦躁 舌干 心烦 四肢疼痛 舌肿 咽喉痛 咽干 丹毒
角色0 ： 山药 龙眼 龙眼肉 茯苓 人参 当归 酸枣仁 白术 远志 甘草  角色1 ： 牛蒡 玄参 薄荷 牛蒡子 羚羊角 荆芥 桔梗 橘红 甘草 大青叶  角色2 ： 杏仁 杏 桃 桃仁 蓖麻 蓖麻子 葱白 巴豆 乳香 鸡子  角色3 ： 白芍 茜草 地榆 当归 蒲黄 藕节 三七 荷叶 阿胶 槐花	吐血 咳嗽 鼻衄 便血 耳聋 崩漏 健忘 月经过多 尿血 头痛
角色0 ： 菟丝子 肉苁蓉 牛膝 五味子 杜仲 远志 覆盆子 鹿茸 枸杞子 茯苓  角色1 ： 石斛 附子 防风 山茱萸 白术 茯苓 人参 泽泻 干姜 牛膝  角色2 ： 山药 泽泻 山茱萸 茯苓 牡丹 牡丹皮 熟地黄 肉桂 当归 五味子  角色3 ： 远志 人参 柏子仁 麦门冬 石菖蒲 茯苓 五味子 酸枣仁 当归 天门冬	盗汗 健忘 耳聋 少气 腰痛 目昏 心烦 吐血 小便频数 远视
角色0 ： 附子 白附子 天南星 半夏 川乌 僵蚕 天麻 乌头 麝香 藿香  角色1 ： 羌活 川芎 防风 麻黄 白芷 细辛 天麻 独活 甘草 藁本  角色2 ： 麝香 牛黄 朱砂 全蝎 僵蚕 天麻 雄黄 天竺黄 钩藤 琥珀  角色3 ： 天麻 僵蚕 人参 全蝎 茯苓 甘草 白术 防风 远志 桔梗	痫 慢惊 头痛 咳嗽 急惊 鼻塞 目昏 神昏 口噤 半身不遂
角色0 ： 白芍 白术 芍药 陈皮 人参 甘草 茯苓 当归 紫檀 肉豆蔻  角色1 ： 乌梅 甘草 罂粟 罂粟壳 诃子 干姜 当归 木香 地榆 黄连  角色2 ： 知母 黄柏 五味子 生地黄 当归 熟地黄 麦门冬 天门冬 川芎 牛膝  角色3 ： 车前子 车前 防风 决明子 菊花 青葙子 青葙 细辛 黄连 茺蔚子	目昏 脱肛 盗汗 吐血 便血 咳嗽 里急后重 腹痛 自汗 消瘦
角色0 ： 豆蔻 丁香 木香 檀香 砂仁 甘草 白豆蔻 沉香 肉桂 诃子  角色1 ： 生姜 白术 人参 厚朴 茯苓 槟榔 半夏 甘草 木香 前胡  角色2 ： 藿香 白芷 广藿香 半夏 陈皮 桔梗 薄荷 紫苏叶 防风 枳壳  角色3 ： 藿香 香薷 甘草 茯苓 木瓜 厚朴 葛根 陈皮 大腹皮 泽泻	呕吐 恶心 转筋 腹痛 头痛 胸闷 上吐下泻 小儿呕吐 腹泻 口渴
角色0 ： 白芷 甘松 藿香 零陵香 细辛 藁本 附子 当归 香附 川芎  角色1 ： 麝香 木香 沉香 丁香 乳香 檀香 朱砂 香附 豆蔻 荜茇  角色2 ： 没药 乌头 地龙 乳香 五灵脂 川乌 草乌 自然铜 附子 木鳖子  角色3 ： 芍药 当归 牛膝 没药 细辛 骨碎补 赤芍 川乌 川芎 羌活	头痛 牙痛 瘫痪 浮肿 口臭 半身不遂 骨痛 粉刺 神昏 少气
角色0 ： 杜仲 白芍 川芎 当归 续断 白术 阿胶 甘草 香附 砂仁  角色1 ： 女贞 女贞子 桑 何首乌 桑椹 菟丝子 枸杞子 墨旱莲 熟地黄 黄精  角色2 ： 党参 黄芪 白术 甘草 陈皮 茯苓 当归 白芍 大枣 山药  角色3 ： 牡蛎 龙骨 茯苓 山药 车前 车前子 黄柏 桃 白术 远志	头晕 心悸 胎动不安 白带 赤白带 多梦 食欲不振 头昏 崩漏 疲乏
角色0 ： 五加 五加皮 红花 牛膝 当归 羌活 川芎 独活 木瓜 续断  角色1 ： 桑 桑枝 秦艽 桑寄生 威灵仙 红花 丹参 防风 当归 鸡血藤  角色2 ： 桃 桃仁 当归 大黄 芍药 水蛭 蒲黄 赤芍 牡丹 虻虫  角色3 ： 甘草 防风 桔梗 阿胶 大豆 茯苓 杏 干姜 白蔹 当归	心烦 发狂 半身不遂 恶露不下 四肢疼痛 腹满 四肢麻木 难产 腰痛 胞衣不下
角色0 ： 神曲 山楂 麦芽 鸡内金 黄连 槟榔 茯苓 枳壳 使君子 青皮  角色1 ： 山药 茯苓 白术 甘草 人参 白扁豆 芡实 莲子 薏苡仁 陈皮  角色2 ： 车前 车前子 甘草 白术 陈皮 泽泻 茯苓 厚朴 半夏 白芍  角色3 ： 木通 葛根 荆芥 薄荷 藿香 青皮 半夏 防风 枳实 槟榔	腹痛 疳积 腹泻 积滞 食欲不振 口渴 呕吐 头痛 头晕 大便秘结
角色0 ： 厚朴 附子 白术 干姜 生姜 吴茱萸 人参 当归 枳实 甘草  角色1 ： 前胡 甘草 防风 石膏 细辛 旋覆花 枳壳 半夏 茯苓 菊花  角色2 ： 麦门冬 远志 当归 茯苓 人参 甘草 酸枣仁 生地黄 五味子 川芎  角色3 ： 生姜 大枣 甘草 芍药 半夏 人参 黄芩 桂枝 葱白 柴胡	短气 头痛 腹满 少气 自汗 目昏 干呕 恶寒 烦躁 心烦
角色0 ： 麝香 大戟 雄黄 丁香 冰片 朱砂 沉香 藿香 檀香 细辛  角色1 ： 五加 五加皮 牛膝 防风 当归 丹参 羌活 薏苡仁 独活 附子  角色2 ： 桑 桑白皮 茯苓 木通 大腹皮 陈皮 泽泻 槟榔 甘草 木香  角色3 ： 竹叶 淡竹 淡竹叶 甘草 石膏 黄芩 人参 麦门冬 生地黄 木通	浮肿 小便不利 腹痛 心烦 恶心 烦躁 腰痛 头昏 干呕 耳聋
角色0 ： 柴胡 黄芩 甘草 白芍 当归 青皮 枳壳 栀子 薄荷 芍药  角色1 ： 枇杷叶 枇杷 竹茹 甘草 麦门冬 人参 枳壳 藿香 生姜 芦根  角色2 ： 川芎 陈皮 当归 白芍 香附 白术 甘草 砂仁 麦冬 熟地黄  角色3 ： 茯苓 人参 半夏 白术 甘草 蓼蓝 白花蛇舌草 陈皮 鹿角霜 丁香	呕吐 心烦 胁痛 干呕 口苦 寒热往来 潮热 咽干 呃逆 五心烦热
角色0 ： 琥珀 牛黄 麝香 天竺黄 朱砂 人参 雄黄 甘草 沉香 茯苓  角色1 ： 麝香 冰片 珍珠 硼砂 熊胆 牛黄 黄连 炉甘石 朱砂 琥珀  角色2 ： 木贼 藜 蒺藜 菊花 石决明 防风 甘草 羌活 蝉蜕 荆芥  角色3 ： 冰片 牛黄 郁金 黄连 朱砂 黄芩 雄黄 珍珠 栀子 大黄	烦躁 神昏 流泪 痫 谵语 目昏 胬肉攀睛 急惊 胎毒 拳毛倒睫
