甘草 茯苓 人参 白术 半夏 陈皮 肉桂 干姜 五味子 当归	咳嗽 头痛 腹满 潮热 消瘦 盗汗 烦躁 咽干 心烦 头昏
升麻 犀角 麦门冬 黄芩 知母 甘草 羚羊角 石膏 柴胡 玄参	烦躁 壮热 咽喉痛 舌干 丹毒 潮热 牙龈肿痛 寒战 大便秘结 口噤
杏仁 杏 紫菀 款冬花 麻黄 百合 百部 苦杏仁 紫苏子 白前	咳嗽 气喘 咳痰 喉痒 妊娠咳嗽 咽干 身重 胸痛 舌裂 鼻塞
木香 青皮 三棱 槟榔 莪术 陈皮 香附 砂仁 姜黄 丁香	积滞 恶心 呕吐 腹满 吞酸 寒热往来 大便溏 疳积 口臭 胁痛
槟榔 木香 枳壳 牵牛 郁李 郁李仁 防己 大腹皮 大黄 木通	浮肿 气喘 大便秘结 腹满 烦躁 腰重 咳嗽 身重 月经过多 带状疱疹
甘草 芍药 柴胡 赤芍 知母 地骨皮 鳖甲 麦门冬 人参 秦艽	心烦 五心烦热 潮热 四肢疼痛 寒热往来 口渴 汗血 不寐 心悸 身重
乳香 没药 轻粉 血竭 白芷 白及 白蔹 五灵脂 穿山甲 麝香	瘰疬 臁疮 无名肿毒 烦躁 便血 胞衣不下 唇肿 肥胖 喉痒 胃痛
黄芩 大黄 栀子 黄连 竹叶 淡竹 郁金 连翘 淡竹叶 薄荷	烦躁 谵语 发狂 大便秘结 口渴 神昏 舌肿 漏下 咳血 干呕
远志 丹参 山药 党参 五味子 黄芪 何首乌 石菖蒲 酸枣仁 柏子仁	头晕 心悸 健忘 多梦 胸闷 疲乏 食欲不振 须发早白 脱发 小便频数
当归 阿胶 白芍 川芎 芍药 艾叶 续断 蒲黄 地榆 炙甘草	崩漏 胎动不安 漏下 崩中 胎漏 尿血 吐血 心烦 胎毒 头晕
黄连 柴胡 胡黄连 芦荟 鳖甲 青黛 使君子 芥子 白芥 白芥子	潮热 盗汗 消瘦 疳积 鼻痒 面色青 口臭 小儿腹痛 言语错乱 脱肛
桑 杏 桑白皮 杏仁 五味子 桑寄生 紫菀 桑叶 麻黄 桑螵蛸	咳嗽 气喘 寒热往来 舌肿 赤脉传睛 鼻衄 骨痛 丹毒 腹泻 尿血
甘草 茯苓 人参 白术 当归 半夏 桔梗 炙甘草 麻黄 生姜	头痛 神昏 壮热 鼻塞 脱肛 烦躁 腹满 咽干 痫 头昏
木通 大黄 滑石 甘草 黄芩 瞿麦 石膏 寒水石 冬葵 冬葵子	小便不通 小便不利 尿血 腹满 阴疮 鼻干 四肢拘急 发黄 妊娠小便不通 不射精
人参 干姜 白术 附子 肉桂 益智 茯苓 甘草 当归 木香	腹痛 遗尿 畏寒 肠鸣 呕吐 腹泻 脱肛 少气 小儿遗尿 胁痛
甘草 柴胡 黄芩 芍药 赤芍 当归 知母 桔梗 白芍 葛根	口苦 舌干 胁痛 寒热往来 咽干 但热不寒 心烦 气喘 寒战 咳痰
防风 木瓜 羌活 川芎 苍术 当归 白芷 独活 牛膝 川乌	半身不遂 杨梅疮 瘫痪 骨痛 四肢麻木 关节疼痛 皮肤瘙痒 转筋 腹痛 背痛
当归 香附 白芍 川芎 乌药 砂仁 益母草 延胡索 肉桂 熟地黄	腹痛 不孕 头晕 闭经 胁痛 产后腹痛 胞衣不下 经行腹痛 胃痛 肠鸣
人参 甘草 白术 茯苓 当归 麻黄 麦门冬 牡蛎 炙甘草 大枣	自汗 盗汗 少气 不寐 咳嗽 潮热 头昏 角弓反张 妊娠呕吐 小便不利
附子 细辛 防风 乌头 川乌 麻黄 干姜 草乌 防己 秦艽	口噤 角弓反张 半身不遂 瘫痪 恶风 壮热 项强 腰重 牙痛 背痛
陈皮 半夏 厚朴 苍术 甘草 茯苓 藿香 枳实 白术 砂仁	呕吐 恶心 舌疮 头晕 臂痛 大便秘结 小儿丹毒 漏睛 便血 小儿口疮
当归 白芍 川芎 芍药 甘草 白术 炙甘草 炮姜 黄芩 陈皮	腹痛 胁痛 心烦 少腹痛 肠鸣 畏寒 干呕 吐血 舌强 胎毒
麝香 朱砂 雄黄 巴豆 冰片 青黛 白矾 硼砂 轻粉 蟾酥	牙痛 痫 慢惊 口臭 急惊 湿疮 胎毒 无名肿毒 流泪 胬肉攀睛
人参 甘草 茯苓 白术 干姜 半夏 生姜 芍药 陈皮 炙甘草	短气 自汗 呕吐 背痛 恶心 头晕 腹冷 少气 鼻干 四肢疼痛
五味子 麦门冬 人参 远志 山药 天门冬 茯苓 山茱萸 生地黄 磁石	耳聋 少气 盗汗 健忘 头昏 自汗 头重 便血 崩漏 善怒
黄连 黄柏 当归 黄芩 乌梅 地榆 生地黄 枳壳 诃子 槐花	吐血 里急后重 便血 脱肛 大便下血 胞衣不下 脐疮 寒热往来 丹毒 瘰疬
人参 甘草 茯苓 白术 当归 麦门冬 半夏 陈皮 郁金 防风	心烦 烦躁 短气 咽干 谵语 口淡 不寐 咳嗽 寒热往来 瘰疬
干姜 附子 吴茱萸 肉桂 硫黄 厚朴 石榴 当归 石榴皮 丁香	腹痛 腹冷 转筋 手足厥冷 面色青 上吐下泻 呃逆 浮肿 舌肿 崩漏
神曲 山楂 陈皮 砂仁 麦芽 厚朴 藿香 香附 青皮 枳实	吞酸 呕吐 嘈杂 嗳气 食欲不振 腹泻 胸闷 胃痛 舌苔白 口臭
半夏 生姜 陈皮 人参 白术 厚朴 竹茹 甘草 枳实 芦根	呕吐 干呕 呃逆 心下痞 身痛 阴挺 头晕 小儿呕吐 项强 不孕
甘草 茯苓 车前 车前子 白术 人参 枳壳 陈皮 当归 炙甘草	腹痛 难产 小便不利 目昏 气喘 小便黄赤 腹泻 发狂 头热 尿血
桃 桃仁 红花 藜 当归 蒺藜 赤芍 菊花 牛膝 泽兰	目昏 流泪 皮肤瘙痒 胸痛 头昏 恶露不下 大便秘结 远视 吐血 粉刺
天麻 僵蚕 附子 白附子 全蝎 天南星 蜈蚣 朱砂 麝香 蝉蜕	慢惊 急惊 痫 神昏 角弓反张 舌强 壮热 目昏 足热 头胀
麦冬 玄参 知母 甘草 沙参 天冬 黄柏 天花粉 白芍 北沙参	口渴 咽干 心烦 舌干 咳血 自汗 消瘦 咽肿 小儿发热 嘈杂
甘草 生姜 桂枝 麻黄 大枣 人参 芍药 茯苓 葱白 半夏	恶寒 无汗 恶风 身痛 呕吐 身重 小儿发热 血精 壮热 骨痛
杜仲 牛膝 菟丝子 肉苁蓉 续断 鹿茸 鹿角 枸杞子 石斛 补骨脂	腰痛 小便频数 不孕 腰膝无力 头昏 腰脊痛 产后腰痛 远视 畏寒 腰重
龙骨 茴香 牡蛎 当归 赤石脂 香附 小茴香 肉桂 硫黄 附子	白带 赤白带 崩中 目昏 小便不利 漏下 干呕 耳聋 尿后余沥 善惊
防风 羌活 川芎 白芷 荆芥 细辛 苍术 甘草 独活 桔梗	恶寒 头痛 恶寒发热 身痛 无汗 舌苔白 产后血崩 舌疮 瞳神散大 四肢拘急
桔梗 枳壳 前胡 甘草 半夏 旋覆花 陈皮 紫苏叶 芍药 麻黄	咳嗽 头痛 鼻塞 多唾 目昏 胃痛 心下悸 恶寒 干呕 咽干
薄荷 连翘 荆芥 牛蒡 牛蒡子 荷叶 桔梗 金银花 蝉蜕 天花粉	麻疹 头痛 丹毒 瘰疬 痄腮 粉刺 皮肤瘙痒 口渴 牙痛 牙龈肿痛
桔梗 半夏 甘草 橘红 枳壳 前胡 枇杷 枇杷叶 瓜蒌 川贝母	咳嗽 胸闷 头晕 咽肿 手足厥冷 发狂 鼻干 阴疮 舌裂 心烦
木香 生姜 厚朴 大黄 槟榔 巴豆 枳实 沉香 甘遂 芫花	腹痛 腹满 反胃 噎膈 胃痛 身重 产后腹痛 短气 丹毒 痄腮
防风 羌活 独活 羚羊角 牛膝 五加 五加皮 菊花 细辛 麻黄	目昏 项强 四肢拘急 恶风 四肢疼痛 头重 转筋 舌强 背痛 自汗
丁香 豆蔻 肉豆蔻 沉香 木香 白豆蔻 藿香 草豆蔻 檀香 砂仁	呕吐 恶心 肠鸣 吞酸 小儿呕吐 难产 呃逆 白内障 声音嘶哑 头昏
石膏 葛根 甘草 麻黄 黄芩 升麻 柴胡 桔梗 赤芍 前胡	头痛 壮热 鼻干 口臭 舌强 牙痛 臁疮 产后发热 浮肿 足颤
白芷 川芎 细辛 防风 荆芥 藁本 羌活 薄荷 菊花 蔓荆子	头痛 鼻塞 偏头痛 头晕 拳毛倒睫 漏睛 胸痛 壮热 阴痒 大便秘结
茯苓 白术 泽泻 猪苓 人参 木通 甘草 陈皮 石膏 山药	小便不利 浮肿 身重 大便溏 臂痛 舌苔白 肥胖 产后浮肿 背痛 头昏
牛黄 朱砂 麝香 雄黄 琥珀 钩藤 天竺黄 冰片 珍珠 龙齿	痫 神昏 四肢抽搐 不寐 弄舌 耳内流脓 四肢拘急 恶寒发热 尿痛 鼻衄
黄芩 大黄 栀子 黄连 茵陈 柴胡 升麻 黄柏 犀角 龙胆	壮热 发黄 头痛 舌苔黄 小便黄赤 头汗 弄舌 舌苔黄腻 黄汗 痫
芍药 赤芍 当归 牡丹 牡丹皮 生地黄 蒲黄 甘草 延胡索 阿胶	吐血 鼻衄 咳血 舌肿 大便下血 鼻塞 心悸 云雾移睛 面痛 漏下
