天门冬 夜明砂 铁苋菜 鬼针草 土荆芥 火炭母 仙鹤草 青木香 罗汉松 徐长卿	盗汗 远视 腹泻 身热肢寒 腹中痞块 近视 顿咳 耳痛 气喘 咽喉白腐
苍术 栀子 泽泻 滑石 车前 车前子 防己 木通 猪苓 茵陈	小便不利 小便不通 浮肿 发黄 口渴 烦躁 气喘 腹满 难产 咳嗽
厚朴 砂仁 木瓜 藿香 陈皮 甘草 白术 苍术 木香 香附	呕吐 腹痛 恶心 转筋 吞酸 腹满 肠鸣 反胃 嘈杂 浮肿
紫菀 杏 杏仁 桑白皮 款冬花 牛蒡 桑 牛蒡子 枇杷 枇杷叶	咳嗽 气喘 吐血 咽干 胸闷 咳血 咳痰 心烦 口渴 麻疹
半夏 陈皮 桔梗 甘草 前胡 枳实 人参 天南星 竹茹 白术	咳嗽 呕吐 头痛 恶心 气喘 壮热 恶寒 目昏 鼻塞 干呕
铅丹 马钱子 马钱 藤黄 乳香 没药 红粉 木瓜 杜仲 儿茶	四肢麻木 无名肿毒 痫 小儿口疮 瘰疬 带状疱疹 臁疮 胎毒 关节疼痛 阴疮
茯苓 人参 远志 白术 牡蛎 丹参 甘草 朱砂 麦门冬 柏子仁	盗汗 健忘 心烦 心悸 痫 呕吐 咳嗽 小便不利 潮热 烦躁
天麻 全蝎 牛黄 羚羊角 僵蚕 鳖甲 白附子 朱砂 蒺藜 天竺黄	痫 慢惊 神昏 急惊 口噤 壮热 角弓反张 头痛 目昏 耳聋
麝香 冰片 朱砂 石菖蒲 牛黄 蟾酥 猪牙皂 青黛 珍珠 竹沥	痫 慢惊 急惊 神昏 壮热 烦躁 牙痛 口臭 无名肿毒 口噤
韭子 红花 冬葵 冬葵果 草莓 荜茇 狗宝 西红花 降香 黑种草子	白带 崩中 谵语 鼻干 身热肢寒 腹中痞块 近视 顿咳 耳痛 气喘
肉豆蔻 赤石脂 豆蔻 酸枣仁 诃子 益智 龙骨 益智仁 五倍子 覆盆子	腹痛 盗汗 白带 肠鸣 遗尿 里急后重 赤白带 自汗 崩中 脱肛
雄黄 轻粉 朱砂 乳香 没药 血竭 蜈蚣 珍珠 蟾酥 儿茶	臁疮 瘰疬 慢惊 杨梅疮 无名肿毒 急惊 痫 咳嗽 胎毒 湿疮
紫苏叶 柿蒂 苦杏仁 乌梅 丁香 大腹皮 天花粉 法半夏 浙贝母 硼砂	呃逆 咳嗽 咽干 烦躁 口渴 头昏 腹满 短气 恶寒发热 难产
白芍 赤芍 当归 芍药 川芎 香附 五灵脂 白术 熟地黄 肉桂	腹痛 白带 赤白带 心烦 五心烦热 崩漏 胁痛 口苦 自汗 胎动不安
芙蓉叶 夜明砂 青木香 罗汉松 徐长卿 荆芥 椒目 竹叶 淡竹叶 列当	胃痛 恶寒 低热 身热肢寒 腹中痞块 近视 顿咳 耳痛 气喘 咽喉白腐
巴豆 桃仁 桃 郁李 郁李仁 甘遂 紫苏子 巴豆霜 蓖麻 槟榔	浮肿 腹痛 咳嗽 积滞 腹满 气喘 痫 耳聋 大便秘结 小便不通
枳壳 神曲 麦芽 山楂 槟榔 陈皮 青皮 莱菔子 木香 香附	呕吐 腹痛 吞酸 积滞 恶心 嘈杂 食欲不振 腹满 里急后重 嗳气
常山 瓜蒂 胆矾 乌梅 赤小豆 鳖甲 草果 藜芦 芦荟 藜	头痛 鼻塞 痫 寒热往来 头重 发黄 手足厥冷 寒战 但热不寒 口苦
黄芩 甘草 芍药 石膏 知母 玄参 生地黄 连翘 黄柏 麦门冬	烦躁 壮热 头痛 口渴 心烦 咳嗽 吐血 瘰疬 麻疹 谵语
生姜 干姜 甘草 人参 白术 大枣 当归 吴茱萸 薏苡仁 芍药	腹痛 呕吐 短气 腹满 干呕 恶心 肠鸣 少气 咳嗽 吞酸
木香 杏 杏仁 川芎 槟榔 丁香 香附 沉香 青皮 甘草	腹痛 呕吐 咳嗽 恶心 吞酸 气喘 头痛 浮肿 胸闷 腹冷
大黄 当归 乳香 木通 没药 红花 牡丹 牡丹皮 蒲黄 艾叶	腹痛 吐血 瘰疬 便血 鼻衄 大便秘结 无名肿毒 崩漏 白带 小便不通
附子 干姜 橘红 茴香 肉桂 胡椒 白术 白附子 小茴香 丁香	腹痛 呕吐 腹冷 口噤 白带 手足厥冷 赤白带 恶心 自汗 恶寒
香薷 白扁豆 绿豆 藿香 甜瓜 甜瓜子 木瓜 檀香 广藿香 赤小豆	呕吐 腹痛 转筋 恶心 烦躁 头痛 心烦 粉刺 壮热 腹泻
细辛 桑 川乌 秦艽 乌头 草乌 五加皮 五加 牛膝 桑寄生	头痛 半身不遂 瘫痪 浮肿 腰痛 鼻塞 四肢麻木 牙痛 骨痛 目昏
蛇蜕 蜂房 虎骨 忍冬藤 蚕砂 乌梢蛇 红花 钩藤 地龙 蜘蛛	痫 瘰疬 壮热 半身不遂 四肢麻木 脱肛 难产 胞衣不下 骨痛 关节疼痛
甘草 当归 人参 白术 五味子 牛膝 阿胶 杜仲 麦冬 山药	腰痛 咳嗽 吐血 腹痛 自汗 头晕 盗汗 心烦 烦躁 咽干
黄连 白矾 硫黄 胡黄连 黄芩 黄柏 芦荟 大豆 龙胆 青黛	腹痛 里急后重 痫 烦躁 壮热 便血 心烦 白带 呕吐 口臭
麻黄 白芷 荆芥 薄荷 甘草 菊花 川芎 桂枝 防风 藁本	头痛 鼻塞 恶寒 壮热 无汗 咳嗽 恶风 目昏 麻疹 项强
木鳖子 海藻 玄明粉 没药 乳香 昆布 连翘 芒硝 穿山甲 五灵脂	瘰疬 瘫痪 臁疮 无名肿毒 呕吐 白带 大便秘结 臂痛 畏寒 拳毛倒睫
防风 柴胡 羌活 升麻 甘草 独活 葛根 川芎 人参 黄芩	头痛 壮热 恶寒 恶风 项强 潮热 目昏 口苦 烦躁 口噤
使君子 牵牛子 牵牛 芜荑 阿魏 松香 雷丸 樟脑 槟榔 石榴皮	疳积 腹痛 瘰疬 臁疮 消瘦 痫 壮热 口臭 骨痛 恶心
洋金花 太子参 守宫 青木香 罗汉松 徐长卿 荆芥 椒目 竹叶 淡竹叶	胃痛 身热肢寒 腹中痞块 近视 顿咳 耳痛 气喘 咽喉白腐 滑胎 胎漏
