干姜 附子 白术 人参 吴茱萸 生姜 厚朴 茯苓 甘草 肉桂	腹痛 少气 转筋 手足厥冷 肠鸣 腹冷 面色青 短气 背痛 腹满
半夏 人参 茯苓 甘草 生姜 白术 陈皮 大枣 枳实 厚朴	呕吐 短气 腹满 干呕 恶心 心下痞 呃逆 小儿呕吐 多唾 心下悸
陈皮 厚朴 砂仁 香附 苍术 神曲 半夏 藿香 山楂 青皮	呕吐 恶心 吞酸 腹痛 嘈杂 胸闷 嗳气 腹泻 反胃 胃痛
甘草 芍药 枳壳 赤芍 当归 柴胡 前胡 茯苓 藜 黄芩	目昏 胁痛 耳聋 心烦 四肢疼痛 流泪 口苦 头重 寒热往来 皮肤瘙痒
甘草 麦冬 知母 黄连 黄芩 黄柏 人参 生地黄 茯苓 竹叶	烦躁 口渴 心烦 咽干 吐血 不寐 谵语 遗尿 发狂 口臭
大黄 黄芩 黄连 栀子 犀角 升麻 甘草 黄柏 玄参 麦门冬	烦躁 壮热 谵语 发黄 大便秘结 发狂 丹毒 舌干 舌肿 鼻衄
木香 丁香 槟榔 豆蔻 沉香 三棱 青皮 莪术 肉豆蔻 藿香	腹痛 呕吐 恶心 积滞 疳积 肠鸣 消瘦 里急后重 吞酸 反胃
桔梗 甘草 薄荷 连翘 荆芥 枳壳 前胡 牛蒡 荷叶 牛蒡子	咳嗽 头痛 麻疹 鼻塞 恶寒 咽干 丹毒 口渴 恶寒发热 痄腮
麝香 朱砂 牛黄 僵蚕 雄黄 附子 白附子 全蝎 天麻 天南星	痫 慢惊 神昏 急惊 壮热 口噤 角弓反张 头热 四肢抽搐 弄舌
甘草 石膏 黄芩 芍药 麻黄 葛根 赤芍 升麻 柴胡 知母	头痛 壮热 无汗 恶风 恶寒 鼻干 黄汗 项强 口中生疮 胸痛
防风 独活 当归 羌活 牛膝 麻黄 秦艽 细辛 川芎 甘草	腰痛 口噤 半身不遂 项强 四肢拘急 角弓反张 四肢麻木 舌强 瘫痪 杨梅疮
远志 山药 五味子 牡丹 牡丹皮 菟丝子 熟地黄 牛膝 杜仲 山茱萸	头晕 心悸 健忘 腰痛 耳聋 盗汗 小便频数 胸闷 头昏 多梦
茯苓 木通 泽泻 滑石 车前 大黄 车前子 白术 槟榔 猪苓	浮肿 小便不利 小便不通 气喘 腹满 难产 尿血 肥胖 大便秘结 小便黄赤
当归 阿胶 白芍 龙骨 牡蛎 芍药 黄连 赤石脂 地榆 乌梅	吐血 便血 脱肛 崩中 漏下 鼻衄 崩漏 里急后重 胎动不安 尿血
白术 甘草 当归 人参 白芍 茯苓 陈皮 芍药 炙甘草 川芎	自汗 恶寒 身重 恶风 身痛 盗汗 恶寒发热 畏寒 胎动不安 潮热
白芷 川芎 防风 细辛 羌活 川乌 荆芥 苍术 乌头 草乌	头痛 鼻塞 瘫痪 半身不遂 骨痛 牙痛 无汗 头昏 身痛 皮肤瘙痒
人参 甘草 茯苓 麦门冬 柴胡 地骨皮 鳖甲 知母 五味子 白术	潮热 心烦 盗汗 舌干 口苦 五心烦热 寒热往来 咽干 消瘦 但热不寒
乳香 没药 麝香 冰片 白矾 雄黄 巴豆 轻粉 白芷 硼砂	瘰疬 臁疮 无名肿毒 牙痛 杨梅疮 口臭 湿疮 胎毒 难产 粉刺
当归 川芎 桃 桃仁 白芍 香附 茴香 红花 木香 附子	腹痛 白带 赤白带 腰痛 崩漏 不孕 腹冷 胞衣不下 恶露不下 难产
杏 杏仁 桑 桔梗 紫菀 桑白皮 半夏 五味子 麻黄 款冬花	咳嗽 气喘 咳痰 喉痒 妊娠咳嗽 身痛 哮鸣 顿咳 小儿腹痛 口渴
