豆蔻 木香 肉豆蔻 丁香 干姜 甘草 青皮 陈皮 人参 白术	呕吐 肠鸣 恶心 腹痛 吞酸 反胃 积滞 腹满 腹冷 口苦
当归 白芷 苦参 防风 川芎 茯苓 甘草 土茯苓 威灵仙 荆芥	杨梅疮 瘰疬 头痛 臁疮 皮肤瘙痒 咳嗽 麻疹 瘫痪 阴疮 骨痛
当归 阿胶 芍药 甘草 白芍 人参 艾叶 川芎 龙骨 干姜	腹痛 白带 崩中 赤白带 漏下 胎动不安 崩漏 胎漏 吐血 少气
杏 杏仁 甘草 麻黄 半夏 茯苓 桑 人参 桔梗 桑白皮	咳嗽 气喘 鼻塞 无汗 咳痰 头昏 喉痒 恶风 寒热往来 咽干
黄连 黄芩 当归 甘草 大黄 黄柏 赤芍 川芎 枳壳 栀子	里急后重 腹痛 大便秘结 烦躁 便血 口苦 牙痛 大便下血 舌干 脱肛
草乌 川乌 白芷 当归 雄黄 甘草 细辛 麝香 半夏 白及	瘰疬 头痛 耳聋 吐血 无名肿毒 瘫痪 牙痛 半身不遂 臁疮 恶心
香附 莪术 木香 三棱 甘草 青皮 砂仁 陈皮 当归 枳壳	腹痛 呕吐 恶心 吞酸 嘈杂 胃痛 嗳气 胁痛 积滞 胸闷
甘草 五味子 桑 麦门冬 紫菀 茯苓 人参 杏仁 杏 款冬花	咳嗽 气喘 短气 多唾 妊娠咳嗽 咳血 食欲不振 面色白 胎漏 骨痛
当归 丹参 甘草 川芎 夏枯草 茯苓 香附 昆布 益母草 白术	瘰疬 腹痛 胸闷 浮肿 胁痛 白带 心悸 肥胖 舌苔黄 不孕
乳香 没药 麝香 血竭 雄黄 轻粉 冰片 朱砂 丁香 大黄	瘰疬 臁疮 无名肿毒 腹痛 湿疮 杨梅疮 牙痛 积滞 反胃 胎毒
牵牛 郁李 郁李仁 大黄 槟榔 甘遂 牵牛子 木香 茯苓 巴豆	浮肿 小便不利 气喘 小便不通 腹满 咳嗽 大便秘结 痫 积滞 难产
茴香 附子 木香 乌药 沉香 小茴香 当归 吴茱萸 干姜 牛膝	腹冷 白带 腹痛 赤白带 腰痛 转筋 手足厥冷 目昏 面色青 气喘
防风 甘草 桑 独活 当归 桑寄生 白术 人参 细辛 麻黄	口噤 恶风 耳聋 腰痛 角弓反张 半身不遂 项强 短气 舌强 背痛
龙胆 柴胡 黄连 甘草 黄芩 胡黄连 青蒿 大黄 当归 栀子	潮热 心烦 盗汗 口渴 五心烦热 烦躁 口苦 耳聋 咳嗽 胁痛
炙甘草 甘草 陈皮 半夏 茯苓 白术 当归 羌活 人参 防风	恶寒 呕吐 心下痞 身重 头痛 自汗 呃逆 舌苔白 大便溏 肠鸣
甘草 桔梗 茯苓 桑 瓜蒌 黄芩 黄连 陈皮 知母 半夏	咳嗽 潮热 疳积 消瘦 咽干 口渴 咳血 气喘 吐血 鼻干
甘草 陈皮 砂仁 厚朴 苍术 白术 茯苓 神曲 木香 半夏	呕吐 腹痛 吞酸 恶心 嘈杂 嗳气 反胃 腹满 噎膈 积滞
朱砂 麝香 附子 白附子 牛黄 天南星 雄黄 僵蚕 巴豆 天麻	慢惊 痫 急惊 神昏 口噤 角弓反张 舌强 四肢拘急 项强 壮热
泽泻 甘草 茯苓 木通 猪苓 大黄 黄芩 栀子 滑石 茵陈	小便不通 小便不利 发黄 尿血 口渴 难产 小便黄赤 头汗 烦躁 咽肿
甘草 荆芥 连翘 防风 牛蒡 黄芩 牛蒡子 桔梗 川芎 木通	头痛 麻疹 鼻塞 丹毒 壮热 谵语 烦躁 口渴 咽干 头昏
甘草 桔梗 前胡 防风 枳壳 薄荷 羌活 荆芥 杏仁 杏	咳嗽 头痛 恶寒 无汗 鼻塞 麻疹 恶寒发热 壮热 口渴 身痛
牡丹 牡丹皮 橘红 甘草 芍药 当归 茯苓 赤芍 半夏 白术	头痛 目昏 腹痛 胁痛 舌干 恶寒 壮热 口苦 寒热往来 盗汗
甘草 石膏 牛黄 大黄 人参 龙齿 寒水石 青黛 钩藤 滑石	痫 壮热 烦躁 发狂 舌干 心烦 舌疮 舌肿 湿疮 言语错乱
麦冬 甘草 当归 天冬 沙参 茯苓 白芍 人参 远志 五味子	口渴 心悸 咽干 头痛 自汗 心烦 头晕 健忘 不寐 鼻塞
甘草 黄芩 黄连 生地黄 麦冬 犀角 当归 知母 柴胡 芍药	吐血 烦躁 心烦 潮热 鼻衄 咽干 谵语 口渴 盗汗 五心烦热
甘草 人参 麻黄 干姜 白术 茯苓 细辛 桂枝 当归 桔梗	盗汗 恶寒 自汗 壮热 无汗 口苦 恶风 头痛 潮热 寒热往来
杏仁 杏 防风 羚羊角 麻黄 黄芩 升麻 甘草 大黄 人参	头痛 壮热 项强 鼻塞 四肢拘急 恶风 目昏 神昏 烦躁 头重
牛膝 杜仲 当归 木瓜 羌活 续断 防风 菟丝子 甘草 鹿茸	腰痛 半身不遂 四肢麻木 白带 关节疼痛 赤白带 骨痛 不孕 瘫痪 足痛
麝香 白矾 雄黄 朱砂 黄连 丁香 胡黄连 半夏 青黛 芦荟	壮热 痫 慢惊 口臭 瘰疬 急惊 口噤 疳积 手足厥冷 鼻痒
芥子 白芥 白芥子 甘草 杏 杏仁 桔梗 半夏 麦冬 桑	咳嗽 咽干 气喘 口渴 烦躁 胸闷 咳痰 腹满 舌干 发狂
乳香 没药 当归 白芷 甘草 防风 僵蚕 赤芍 连翘 羌活	头痛 瘰疬 无名肿毒 发狂 恶心 舌干 头晕 偏头痛 呃逆 烦躁
藜 蒺藜 鹿角 鹿角胶 茯苓 当归 人参 甘草 桑 桑螵蛸	腹痛 腰痛 自汗 盗汗 心烦 白带 浮肿 崩漏 遗尿 头晕
甘草 人参 白术 当归 茯苓 干姜 肉桂 川芎 附子 陈皮	腹痛 呕吐 浮肿 恶寒 头痛 手足厥冷 自汗 难产 身痛 肠鸣
桃 桃仁 当归 甘草 升麻 豆蔻 草豆蔻 人参 柴胡 白术	腹痛 短气 恶寒 自汗 脱肛 面色青 转筋 呵欠 肠鸣 大便秘结
益智 益智仁 当归 桃 红花 桃仁 川芎 赤芍 甘草 丹参	腹痛 头晕 畏寒 遗尿 健忘 鼻衄 小便频数 胸闷 胸痛 腹满
木香 丁香 巴豆 乳香 赭石 薄荷 朱砂 麝香 代赭石 当归	腹痛 骨痛 恶心 呕吐 难产 吐血 腹满 腰痛 白带 胞衣不下
甘草 芍药 麦门冬 黄芩 赤芍 石膏 升麻 柴胡 葛根 知母	壮热 头痛 烦躁 舌干 心烦 四肢疼痛 舌肿 咽喉痛 咽干 丹毒
杏仁 杏 桃 甘草 当归 桃仁 山药 玄参 白芍 龙眼	吐血 咳嗽 鼻衄 便血 耳聋 崩漏 健忘 月经过多 尿血 头痛
茯苓 山茱萸 人参 五味子 山药 泽泻 远志 石斛 牛膝 菟丝子	盗汗 健忘 耳聋 少气 腰痛 目昏 心烦 吐血 小便频数 远视
天麻 附子 僵蚕 白附子 防风 全蝎 甘草 羌活 川芎 半夏	痫 慢惊 头痛 咳嗽 急惊 鼻塞 目昏 神昏 口噤 半身不遂
甘草 当归 人参 白芍 乌梅 茯苓 白术 知母 黄柏 芍药	目昏 脱肛 盗汗 吐血 便血 咳嗽 里急后重 腹痛 自汗 消瘦
甘草 厚朴 生姜 藿香 茯苓 木香 白术 半夏 人参 豆蔻	呕吐 恶心 转筋 腹痛 头痛 胸闷 上吐下泻 小儿呕吐 腹泻 口渴
乳香 麝香 白芷 没药 当归 木香 川乌 沉香 甘松 细辛	头痛 牙痛 瘫痪 浮肿 口臭 半身不遂 骨痛 粉刺 神昏 少气
党参 当归 白术 白芍 牡蛎 茯苓 杜仲 甘草 山药 女贞	头晕 心悸 胎动不安 白带 赤白带 多梦 食欲不振 头昏 崩漏 疲乏
当归 桃 牛膝 桑 大黄 桃仁 芍药 蒲黄 红花 秦艽	心烦 发狂 半身不遂 恶露不下 四肢疼痛 腹满 四肢麻木 难产 腰痛 胞衣不下
车前 山药 茯苓 车前子 白术 甘草 山楂 麦芽 神曲 陈皮	腹痛 疳积 腹泻 积滞 食欲不振 口渴 呕吐 头痛 头晕 大便秘结
甘草 生姜 人参 茯苓 当归 厚朴 大枣 半夏 麦门冬 远志	短气 头痛 腹满 少气 自汗 目昏 干呕 恶寒 烦躁 心烦
竹叶 五加 五加皮 淡竹 甘草 桑 淡竹叶 茯苓 桑白皮 木通	浮肿 小便不利 腹痛 心烦 恶心 烦躁 腰痛 头昏 干呕 耳聋
甘草 柴胡 人参 茯苓 白术 半夏 白芍 当归 黄芩 川芎	呕吐 心烦 胁痛 干呕 口苦 寒热往来 潮热 咽干 呃逆 五心烦热
牛黄 麝香 冰片 朱砂 珍珠 琥珀 甘草 黄连 雄黄 天竺黄	烦躁 神昏 流泪 痫 谵语 目昏 胬肉攀睛 急惊 胎毒 拳毛倒睫
