甘草 当归 茯苓 桔梗 人参 川芎 柴胡 半夏 白术 陈皮	恶寒 恶寒发热 无汗 身痛 舌苔白 头重 乳汁不行 胸闷 骨痛 乳房红肿
甘草 茯苓 白术 当归 木香 人参 半夏 陈皮 附子 防风	腹痛 转筋 手足厥冷 上吐下泻 头昏 面色青 干呕 产后腹痛 腹冷 口腻
甘草 茯苓 当归 人参 白术 川芎 黄芩 枳壳 防风 附子	壮热 头痛 烦躁 寒战 小便不通 鼻痒 头重 赤膜下垂 鼻痛 胸闷
甘草 茯苓 当归 白术 人参 黄连 芍药 桔梗 川芎 防风	盗汗 潮热 消瘦 自汗 善食易饥 大便艰难 脏躁 不孕 腹痛 肛门疼痛
甘草 茯苓 当归 人参 防风 川芎 白术 黄芩 附子 木香	头痛 鼻塞 目昏 皮肤瘙痒 头昏 咳嗽 痱子 鼻痛 背痛 面色红
甘草 人参 当归 茯苓 黄芩 白术 防风 川芎 芍药 半夏	口噤 角弓反张 项强 舌强 四肢拘急 言语错乱 头摇 四肢强直 产后发痉 手颤
甘草 茯苓 当归 白术 陈皮 人参 半夏 黄芩 木香 干姜	腹痛 面色青 手足厥冷 浮肿 少腹痛 转筋 失语 头冷 白内障 牙齿浮动
甘草 茯苓 人参 当归 附子 白术 陈皮 芍药 半夏 大黄	浮肿 小便不利 短气 肠鸣 牙痛 心下痞 腰脊痛 气喘 恶风 四肢疼痛
甘草 人参 茯苓 白术 黄芩 当归 川芎 防风 木香 干姜	咳嗽 呕吐 气喘 赤脉传睛 胸痛 顿咳 耳聋 经间期出血 心下痞 目羞明
甘草 当归 人参 茯苓 白术 芍药 白芍 陈皮 半夏 木香	咳嗽 吐血 寒热往来 小便不通 鼻衄 麻疹 多唾 便血 胎漏 舌纵
甘草 当归 黄芩 茯苓 人参 大黄 柴胡 川芎 防风 半夏	瘰疬 丹毒 无名肿毒 胎毒 杨梅疮 痄腮 麻疹 阴疮 小儿丹毒 带状疱疹
甘草 茯苓 当归 白术 人参 山药 陈皮 杜仲 熟地黄 女贞子	头晕 健忘 心悸 疲乏 食欲不振 畏寒 多梦 须发早白 脱发 头昏
甘草 当归 人参 白术 茯苓 黄芩 防风 半夏 芍药 陈皮	头痛 咳嗽 鼻塞 恶寒 壮热 恶风 身痛 四肢抽搐 赤膜下垂 恶寒发热
甘草 当归 黄芩 黄连 大黄 茯苓 防风 麝香 木香 杏	瘰疬 臁疮 无名肿毒 杨梅疮 湿疮 半身不遂 疳积 牙痛 发黄 天疱疮
甘草 当归 茯苓 防风 人参 白术 川芎 附子 芍药 木香	腰痛 四肢麻木 骨痛 关节疼痛 腰膝无力 背痛 产后腰痛 耳痒 囟门不合 恶露不下
甘草 茯苓 当归 白术 人参 杏仁 芍药 陈皮 防风 半夏	头痛 恶寒 鼻塞 恶风 无汗 壮热 项强 身重 发黄 面痛
甘草 茯苓 当归 人参 半夏 白术 木香 黄芩 附子 柴胡	咳嗽 气喘 畏寒 吐血 背冷 寒热往来 妊娠心腹胀满 妊娠咳嗽 小儿发热 小便黄赤
甘草 茯苓 白术 当归 半夏 陈皮 黄芩 枳壳 人参 柴胡	吞酸 嘈杂 嗳气 呃逆 胃痛 食欲不振 恶心 四肢抽搐 小儿痞块 疳翳
甘草 当归 人参 茯苓 白术 黄芩 川芎 白芍 黄连 大黄	心烦 五心烦热 咽干 咽喉痛 尿痛 善悲 独语 妊娠心烦 善怒 善恐
甘草 茯苓 人参 当归 黄芩 附子 木香 陈皮 半夏 川芎	积滞 腹痛 疳积 脱肛 里急后重 大便下血 腹泻 大便溏 便血 肛门瘙痒
甘草 人参 茯苓 黄芩 当归 黄连 川芎 半夏 防风 白术	神昏 谵语 发狂 痫 烦躁 不寐 口中生疮 口流涎 独语 手舞足蹈
甘草 当归 人参 茯苓 白术 木香 半夏 川芎 芍药 防风	痫 慢惊 腹满 壮热 瘰疬 体臭 鼻臭 短气 疲乏 腿肿痛
甘草 茯苓 当归 黄芩 防风 人参 川芎 白术 白芍 柴胡	头痛 鼻塞 呵欠 耳聋 项强 头重 喷嚏 偏头痛 瞳神散大 抱轮红
甘草 茯苓 当归 白术 人参 川芎 木香 芍药 干姜 白芍	白带 赤白带 月经过多 闭经 足跟痛 阴挺 猫眼疮 小儿木舌 红疹 急惊
甘草 人参 茯苓 黄芩 当归 白术 木香 桔梗 石膏 芍药	咳嗽 气喘 头痛 鼻塞 小儿发热 妊娠咳嗽 肩痛 但热不寒 鼻翼煽动 腹痛
甘草 人参 茯苓 当归 桔梗 附子 黄芩 防风 白术 柴胡	呕吐 恶心 吞酸 妊娠呕吐 经行先后无定期 产后胁痛 白内障 小儿呕吐 小儿水痘 头冷
甘草 当归 茯苓 人参 黄芩 白术 白芍 川芎 附子 木香	腹痛 肠鸣 里急后重 产后腹痛 腹中痞块 大便脓血 恶露不下 瘫痪 头面瘙痒 嗳气
甘草 当归 茯苓 人参 白芍 白术 五味子 川芎 黄芩 丹参	头晕 健忘 心悸 心烦 多梦 不寐 头昏 疲乏 畏寒 痴呆
甘草 茯苓 当归 白术 半夏 人参 陈皮 大黄 黄芩 木香	胸闷 头晕 心悸 舌苔白 胸痛 食欲不振 胁痛 积滞 肥胖 舌苔白腻
甘草 茯苓 当归 人参 白术 大黄 半夏 木香 桔梗 芍药	呕吐 恶心 吞酸 嘈杂 小儿呕吐 转筋 食欲不振 胃痛 背冷 自汗
甘草 茯苓 当归 人参 木香 枳壳 白术 陈皮 附子 半夏	小便不通 腹满 浮肿 小便不利 心下痞 大便溏 气喘 妊娠小便不通 寒战 粉刺
甘草 茯苓 当归 白术 人参 半夏 香附 木香 芍药 附子	腹痛 腰痛 胎动不安 胁痛 腹冷 肠鸣 少腹痛 腹泻 大便溏 目札
甘草 当归 人参 茯苓 川芎 白术 黄芩 桔梗 木香 芍药	瘰疬 咳嗽 腹痛 杨梅疮 目昏 牙龈溃烂 白睛红赤 小儿厌食 小儿五软 血灌瞳神
甘草 柴胡 人参 茯苓 黄芩 当归 白术 半夏 芍药 木香	口苦 舌干 胁痛 咽干 寒热往来 小便黄赤 耳聋 但热不寒 阴痛 口酸
甘草 当归 茯苓 黄芩 人参 黄连 川芎 白术 白芍 芍药	吐血 便血 鼻衄 咳血 尿血 大便下血 月经过多 汗血 血精 崩漏
甘草 当归 茯苓 人参 白术 川芎 陈皮 芍药 木香 白芍	浮肿 难产 胞衣不下 腰痛 尿血 崩漏 半身不遂 便血 经行腹痛 产后血崩
甘草 茯苓 白术 人参 当归 川芎 附子 黄芩 芍药 陈皮	崩漏 白带 漏下 崩中 赤白带 胎漏 恶露不下 滑胎 足热 产后发热
甘草 当归 茯苓 白术 人参 黄芩 陈皮 附子 防风 大黄	呕吐 恶心 小儿呕吐 舌麻 小便不利 口淡 目偏视 瘫痪 妇人阴冷 腹痛
甘草 当归 人参 茯苓 柴胡 白芍 陈皮 川芎 半夏 黄芩	盗汗 潮热 自汗 消瘦 寒热往来 心烦 咳嗽 瞳神散大 心下痞 小便黄赤
甘草 当归 茯苓 人参 半夏 白术 川芎 附子 黄芩 大黄	急惊 慢惊 神昏 壮热 烦躁 口噤 头热 弄舌 转筋 经行先后无定期
甘草 茯苓 人参 白术 当归 柴胡 附子 川芎 半夏 芍药	自汗 恶风 恶寒 身重 无汗 身痛 寒战 心下悸 头重 腰重
甘草 人参 当归 白术 茯苓 黄芩 柴胡 川芎 麻黄 半夏	头痛 壮热 烦躁 胎动不安 嗜睡 头重 崩漏 鼻肿 鼻流涕 暴盲
甘草 当归 茯苓 白术 人参 防风 附子 木香 川芎 黄芩	目昏 四肢疼痛 烦躁 四肢拘急 壮热 臂痛 多唾 瘫痪 身重 血灌瞳神
甘草 茯苓 当归 人参 木香 川芎 防风 半夏 芍药 白芍	盗汗 腰痛 自汗 耳聋 头昏 小便频数 健忘 崩漏 不孕 半身不遂
甘草 当归 黄芩 大黄 黄连 茯苓 人参 薄荷 防风 桔梗	大便秘结 牙痛 口臭 舌干 舌肿 咽喉痛 头晕 牙龈肿痛 咽肿 舌疮
甘草 茯苓 当归 白术 人参 芍药 黄芩 川芎 陈皮 防风	咳嗽 麻疹 胁痛 发黄 胎动不安 口臭 耳痛 寒热往来 皮肤瘙痒 小儿发黄
甘草 人参 茯苓 白术 当归 陈皮 附子 干姜 半夏 木香	腹满 干呕 小便不利 短气 身重 寒热往来 足热 面色白 舌光 舌卷
甘草 茯苓 人参 当归 白术 白芍 附子 川芎 山药 陈皮	不孕 腹冷 消瘦 遗尿 小便频数 少气 口淡 闭经 大便溏 面色青
甘草 茯苓 人参 黄芩 当归 柴胡 白术 芍药 白芍 防风	烦躁 口渴 心烦 咽干 鼻干 发狂 大便下血 谵语 目羞明 不射精
甘草 人参 当归 半夏 茯苓 白术 附子 芍药 厚朴 川芎	头痛 壮热 恶露不下 痫 偏头痛 面色红 气喘 舌疮 消瘦 面痛
甘草 茯苓 黄芩 当归 黄连 人参 柴胡 大黄 半夏 白芍	烦躁 心烦 口渴 舌苔黄 大便秘结 口苦 小便黄赤 潮热 发黄 舌苔黄腻
甘草 茯苓 当归 人参 白术 半夏 陈皮 大黄 附子 川芎	腹痛 反胃 呕吐 噎膈 积滞 恶心 肠鸣 胃痛 小儿腹痛 头汗
甘草 人参 茯苓 当归 白术 防风 半夏 附子 芍药 干姜	短气 少气 背痛 项强 远视 恶风 腰脊痛 头重 四肢疼痛 近视
甘草 当归 人参 茯苓 白术 附子 半夏 防风 川芎 麝香	半身不遂 瘫痪 骨痛 舌强 皮肤瘙痒 四肢麻木 足颤 痰核流注 阴痛 神昏
甘草 茯苓 当归 人参 附子 柴胡 白术 川芎 芍药 半夏	目昏 耳聋 腰重 腰膝无力 足痛 小便黄赤 阴挺 膝肿痛 四肢疼痛 臂痛
甘草 当归 茯苓 人参 防风 黄芩 川芎 柴胡 桔梗 黄连	腹痛 呕吐 流泪 腹泻 胬肉攀睛 拳毛倒睫 粉刺 目干涩 蟹睛 夜盲
甘草 当归 茯苓 人参 白术 桔梗 黄芩 防风 荆芥 大黄	咳嗽 烦躁 麻疹 口渴 咽干 头痛 声音嘶哑 潮热 鼻干 舌干
甘草 当归 人参 茯苓 防风 木香 黄芩 半夏 芍药 白术	痫 慢惊 神昏 急惊 弄舌 四肢抽搐 晕厥 鼻痒 角弓反张 发癫
甘草 茯苓 人参 当归 黄芩 杏仁 陈皮 半夏 杏 桑	咽干 咳嗽 口渴 胸闷 咳痰 舌干 喉痒 口苦 咽肿 胸痛
甘草 茯苓 当归 人参 白术 芍药 川芎 附子 麻黄 大黄	咳嗽 气喘 呕吐 吐血 短气 潮热 鼻衄 目昏 背热 赤膜下垂
