角色0 ： 防风 荆芥 羌活 薄荷 川芎 菊花 白芷 葱白 生地黄 山药  角色1 ： 川芎 防风 白芷 羌活 苍术 天麻 荆芥 蔓荆子 细辛 干姜  角色2 ： 防风 独活 羌活 细辛 天麻 藁本 麻黄 川芎 菊花 蝉蜕  角色3 ： 防风 羌活 荆芥 白芷 独活 川芎 秦艽 薄荷 川乌 耳草	头痛 项强 无汗 身痛 鼻塞 麻疹 浮肿 目昏 骨痛 慢惊
角色0 ： 甘草 茯苓 人参 白术 厚朴 前胡 附子 木通 薏苡仁 熟地黄  角色1 ： 茯苓 人参 白术 甘草 当归 土茯苓 白鲜皮 乌头 射干 苦参  角色2 ： 人参 茯苓 甘草 枳壳 白术 陈皮 干姜 独活 防己 大豆  角色3 ： 甘草 白术 茯苓 半夏 干姜 葱白 前胡 诃子 葛根 紫苏叶	恶风 腹痛 咳嗽 气喘 小便不利 阴疮 头重 呕吐 自汗 口噤
角色0 ： 泽泻 猪苓 木通 防己 石膏 肉桂 硫黄 茯苓 橘红 石斛  角色1 ： 滑石 木通 瞿麦 冬葵 冬葵子 石韦 通草 王不留行 半夏 白茅根  角色2 ： 木通 滑石 瞿麦 白茅根 大腹皮 石斛 椒目 秦艽 青皮 茯苓  角色3 ： 车前 车前子 木通 车前草 甘草 赤芍 冬瓜 海金沙 陈皮 槟榔	小便不通 小便不利 难产 小便黄赤 尿血 舌疮 带状疱疹 烦躁 大便下血 恶风
角色0 ： 杏 杏仁 白芍 款冬花 马兜铃 紫苏子 巴豆 朱砂 柴胡 五味子  角色1 ： 杏 杏仁 黄芩 僵蚕 桂枝 石榴皮 芙蓉叶 泽漆 莲子心 鸡子黄  角色2 ： 杏仁 杏 麻黄 青木香 皂荚 紫菀 大枣 甘松 茯苓 桂枝  角色3 ： 杏 杏仁 苦杏仁 紫苏子 麻黄 紫苏叶 葶苈子 川贝母 瓜蒌 百部	咳嗽 气喘 耳聋 恶寒 胸闷 无汗 痫 浮肿 喉痒 头痛
角色0 ： 升麻 玄参 犀角 射干 羚羊角 木通 甘草 芦根 漏芦 麦门冬  角色1 ： 犀角 钩藤 龙齿 蛇蜕 白鲜皮 升麻 牛黄 蜂房 羚羊角 竹沥  角色2 ： 犀角 升麻 麦门冬 羚羊角 木通 苦参 防风 阿魏 地龙 酸枣仁  角色3 ： 升麻 犀角 大黄 麦门冬 羚羊角 枳实 射干 败酱 白术 天南星	壮热 痫 心烦 咽喉痛 脱肛 麻疹 头痛 瘰疬 发狂 神昏
角色0 ： 吴茱萸 干姜 附子 厚朴 细辛 白术 雄黄 巴豆 乌梅 槐花  角色1 ： 干姜 附子 吴茱萸 硫黄 阳起石 生姜 赤石脂 乌梅 诃子 胡芦巴  角色2 ： 干姜 附子 肉桂 枳实 吴茱萸 芍药 紫石英 黄连 桔梗 巴豆  角色3 ： 干姜 吴茱萸 附子 细辛 当归 五灵脂 山药 香附 生姜 郁金	呕吐 手足厥冷 腹痛 吞酸 腹冷 面色青 短气 肠鸣 畏寒 恶心
角色0 ： 香附 川芎 益母草 当归 熟地黄 泽兰 延胡索 党参 阿胶 肉桂  角色1 ： 白芍 当归 川芎 香附 熟地黄 甘草 炙甘草 金银花 侧柏叶 赤石脂  角色2 ： 当归 白芍 川芎 香附 熟地黄 白薇 荆芥 五味子 麦冬 白术  角色3 ： 山药 鹿角 芡实 鹿角胶 莲子 鹿角霜 党参 薏苡仁 莲须 莲子心	白带 赤白带 腹痛 难产 吐血 崩漏 浮肿 漏下 自汗 盗汗
角色0 ： 白芍 当归 芍药 川芎 生地黄 百草霜 茯苓 黄柏 玄参 贯众  角色1 ： 牡丹 牡丹皮 延胡索 肉桂 海螵蛸 羚羊角 黄柏 桃 牛膝 白薇  角色2 ： 山药 熟地黄 泽泻 茯苓 山茱萸 五味子 陈皮 珍珠 乌梅 蛇蜕  角色3 ： 芍药 生地黄 当归 赤芍 川芎 茯苓 鸡子 牛膝 陈皮 硫黄	吐血 白带 五心烦热 盗汗 目昏 赤白带 潮热 耳聋 漏下 腹痛
角色0 ： 黄连 龙胆 胡黄连 黄柏 瓜蒌 硫黄 琥珀 紫草 防风 荷叶  角色1 ： 青黛 黄连 麝香 瓜蒂 芦荟 人中白 硼砂 前胡 郁金 蜗牛  角色2 ： 胡黄连 黄连 芦荟 使君子 芜荑 熊胆 雷丸 鹤虱 夜明砂 滑石  角色3 ： 竹叶 淡竹 淡竹叶 连翘 薄荷 木香 人参 丁香 麦门冬 贯众	烦躁 疳积 潮热 心烦 口臭 盗汗 神昏 呕吐 丹毒 咳嗽
角色0 ： 柴胡 地骨皮 知母 鳖甲 枳壳 赤芍 甘草 常山 雷丸 玳瑁  角色1 ： 柴胡 鳖甲 青蒿 秦艽 乌梅 常山 芍药 知母 葱白 石菖蒲  角色2 ： 柴胡 地骨皮 秦艽 知母 鳖甲 甘草 银柴胡 茯苓 瓜蒌 麦门冬  角色3 ： 柴胡 枳壳 黄芩 桔梗 大黄 甘草 黄连 葱白 川芎 赤芍	潮热 寒热往来 盗汗 胁痛 头痛 五心烦热 烦躁 吐血 咳嗽 脱肛
角色0 ： 竹茹 枇杷 枇杷叶 芦根 橘红 枳实 斑蝥 百草霜 陈皮 黄柏  角色1 ： 甘草 麦门冬 人参 犀角 生地黄 沉香 冬瓜 乳香 苦参 白术  角色2 ： 甘草 人参 麦门冬 茯苓 葛根 黄芩 雄黄 黄连 丁香 漏芦  角色3 ： 甘草 人参 麦门冬 桔梗 半夏 肉桂 藿香 地骨皮 当归 阿胶	干呕 心烦 咳嗽 吐血 呕吐 腹痛 气喘 口渴 舌强 咽干
角色0 ： 当归 红花 赤芍 蒲黄 延胡索 苏木 泽兰 刘寄奴 香附 白薇  角色1 ： 桃 桃仁 红花 琥珀 蒲黄 茜草 冬瓜 阿魏 槐花 白芍  角色2 ： 桃 桃仁 水蛭 虻虫 红花 鬼箭羽 核桃仁 干漆 附子 安息香  角色3 ： 大黄 甘遂 芫花 大戟 巴豆 五灵脂 五倍子 皂荚 千金子 商陆	腹满 腹痛 胸痛 恶露不下 小便不通 少腹痛 鼻衄 崩中 消瘦 粉刺
角色0 ： 茯苓 白术 半夏 甘草 赤小豆 苍术 乌梅 芍药 麦门冬 生姜  角色1 ： 人参 白术 甘草 茯苓 乌梅 陈皮 干姜 葛根 硫黄 川芎  角色2 ： 人参 甘草 白术 茯苓 干姜 厚朴 当归 红花 大枣 紫菀  角色3 ： 茯苓 甘草 半夏 干姜 炙甘草 牛膝 当归 橘红 柏子仁 香附	呕吐 腹痛 舌干 小便不利 腹满 自汗 咳嗽 口苦 气喘 咽干
角色0 ： 香附 砂仁 陈皮 苍术 厚朴 木香 枳实 萝卜 川楝子 白芍  角色1 ： 陈皮 厚朴 青皮 神曲 香附 枳实 苍术 砂仁 草果 乌梅  角色2 ： 神曲 山楂 枳实 麦芽 青皮 莱菔子 厚朴 大麦 砂仁 鸡内金  角色3 ： 神曲 麦芽 山楂 鸡内金 砂仁 莱菔子 谷芽 厚朴 白扁豆 法半夏	恶心 嘈杂 食欲不振 吞酸 腹痛 积滞 嗳气 大便秘结 腹泻 腹满
角色0 ： 半夏 陈皮 茯苓 甘草 白芷 前胡 枳壳 姜黄 藿香 柴胡  角色1 ： 半夏 枳实 陈皮 枳壳 橘红 桂枝 前胡 桔梗 瓜蒌 生姜  角色2 ： 芥子 白芥 白芥子 橘红 白术 枳实 瓜蒌 柴胡 炙甘草 红花  角色3 ： 半夏 茯苓 甘草 橘红 桔梗 枳实 枳壳 芍药 金银花 生地黄	呕吐 腹满 心下痞 反胃 大便秘结 咳嗽 恶寒 头痛 臂痛 壮热
角色0 ： 当归 甘草 白芍 柴胡 升麻 海螵蛸 枳壳 茯苓 麦门冬 硼砂  角色1 ： 当归 芍药 甘草 夏枯草 海藻 昆布 桔梗 白芍 人参 川芎  角色2 ： 牡蛎 龙骨 麻黄 小麦 麻黄根 浮小麦 赤石脂 薄荷 生地黄 远志  角色3 ： 甘草 当归 人参 五味子 桔梗 白术 干姜 陈皮 芍药 大豆	盗汗 瘰疬 腹痛 自汗 咳嗽 气喘 胃痛 短气 心悸 恶寒
角色0 ： 何首乌 女贞子 女贞 熟地黄 枸杞子 黄芪 黄精 制何首乌 金樱子 淫羊藿  角色1 ： 桑 桑寄生 桑螵蛸 桑枝 玉竹 三七 续断 党参 白薇 人参  角色2 ： 党参 丹参 黄芪 三七 郁金 山药 茜草 山楂 人参 牡蛎  角色3 ： 当归 白芍 甘草 续断 阿胶 山药 苍术 前胡 延胡索 远志	头晕 头昏 心悸 腹痛 吐血 烦躁 自汗 须发早白 腰痛 心烦
角色0 ： 木香 枳壳 砂仁 沉香 姜黄 香附 郁金 厚朴 陈皮 檀香  角色1 ： 乌药 香附 木香 砂仁 沉香 陈皮 梅花 磁石 茴香 海螵蛸  角色2 ： 陈皮 青皮 砂仁 香附 木香 苍术 郁金 藿香 丁香 橘核  角色3 ： 香附 砂仁 陈皮 木香 乌药 枳壳 茴香 沉香 炙甘草 豆蔻	恶心 腹痛 呕吐 吞酸 嗳气 嘈杂 胎动不安 咳嗽 产后腹痛 呃逆
角色0 ： 茵陈 栀子 龙胆 柴胡 黄芩 升麻 茵陈蒿 枳实 桔梗 大豆  角色1 ： 大黄 黄芩 栀子 黄连 甘草 苍术 石斛 吴茱萸 郁金 白芷  角色2 ： 栀子 黄芩 大黄 黄连 郁金 荆芥 葱白 鸡血藤 木通 犀角  角色3 ： 黄芩 栀子 大黄 黄连 甘草 枳壳 苦参 山豆根 生姜 陈皮	发黄 烦躁 头痛 心烦 舌苔黄 口苦 腹痛 壮热 舌苔黄腻 咳嗽
角色0 ： 阿胶 当归 蒲黄 赭石 代赭石 侧柏叶 小蓟 藕节 甘草 苦参  角色1 ： 阿胶 艾叶 地榆 续断 苍术 藜芦 当归 乌梅 附子 蜗牛  角色2 ： 地榆 乌梅 罂粟壳 罂粟 石榴 阿胶 槐花 诃子 石榴皮 续断  角色3 ： 龙骨 赤石脂 牡蛎 禹余粮 鹿茸 紫石英 艾叶 卷柏 防风 龟甲	吐血 便血 白带 崩漏 赤白带 崩中 腹痛 漏下 胎漏 尿血
角色0 ： 陈皮 厚朴 苍术 半夏 大腹皮 草果 青皮 藿香 生地黄 乌药  角色1 ： 陈皮 厚朴 苍术 藿香 半夏 枳壳 神曲 桔梗 天花粉 前胡  角色2 ： 藿香 木瓜 厚朴 香薷 广藿香 白扁豆 紫苏叶 砂仁 茶叶 法半夏  角色3 ： 苍术 陈皮 厚朴 藿香 草果 砂仁 半夏 五味子 延胡索 丹参	呕吐 恶心 转筋 身重 头痛 恶寒 浮肿 咳嗽 上吐下泻 腹泻
角色0 ： 槟榔 木香 大黄 木通 青皮 黄芩 延胡索 火麻仁 阿魏 茯苓  角色1 ： 槟榔 枳壳 木香 大黄 大腹皮 黄连 香附 花椒 青皮 牵牛子  角色2 ： 木香 槟榔 大黄 枳壳 白术 吴茱萸 黄柏 石榴 熊胆 百草霜  角色3 ： 牵牛 郁李 郁李仁 牵牛子 防己 槟榔 泽漆 百合 防风 大黄	浮肿 腹痛 里急后重 积滞 大便秘结 小便不利 心下痞 烦躁 赤白带 呵欠
角色0 ： 豆蔻 肉豆蔻 白豆蔻 木香 丁香 沉香 荜澄茄 郁金 荜茇 仙鹤草  角色1 ： 丁香 木香 胡椒 诃子 沉香 荜茇 荜澄茄 柿蒂 砂仁 乌梅  角色2 ： 丁香 沉香 藿香 檀香 甘松 母丁香 零陵香 木香 松香 青木香  角色3 ： 豆蔻 肉豆蔻 草豆蔻 高良姜 诃子 白豆蔻 胡椒 草果 砂仁 红豆蔻	呕吐 肠鸣 腹痛 呃逆 口臭 腹冷 恶心 吞酸 胸闷 小儿呕吐
角色0 ： 菊花 羌活 防风 蔓荆子 羚羊角 旋覆花 蝉蜕 野菊花 龙胆 木香  角色1 ： 藜 蒺藜 石决明 木贼 藜芦 青葙子 青葙 决明子 茺蔚子 谷精草  角色2 ： 防风 荆芥 苦参 菊花 苍耳 苍耳子 薄荷 川芎 辛夷 柏子仁  角色3 ： 茴香 小茴香 川楝子 葫芦 苍术 八角茴香 胡芦巴 补骨脂 甘草 炮姜	目昏 流泪 头痛 腰痛 皮肤瘙痒 头昏 远视 鼻塞 拳毛倒睫 腹冷
角色0 ： 麝香 朱砂 全蝎 蜈蚣 僵蚕 牛黄 天南星 雄黄 白附子 穿山甲  角色1 ： 白附子 附子 天南星 天麻 僵蚕 乌头 草乌 赤小豆 牛黄 雄黄  角色2 ： 全蝎 天麻 僵蚕 朱砂 白附子 蝉蜕 牛胆 犀角 天南星 巴豆  角色3 ： 附子 白附子 天麻 僵蚕 天南星 全蝎 蝉蜕 乌梢蛇 地骨皮 牛胆	慢惊 痫 半身不遂 头痛 咳嗽 瘰疬 角弓反张 急惊 神昏 目昏
角色0 ： 紫菀 五味子 款冬花 百合 天门冬 麦门冬 白石英 甘草 桔梗 梨  角色1 ： 紫菀 款冬花 百部 五味子 马兜铃 白前 百合 射干 阿胶 皂荚  角色2 ： 桑 桑白皮 桑叶 桔梗 紫菀 茯苓 龙骨 梨 黄柏 僵蚕  角色3 ： 桑 桑白皮 桔梗 天门冬 地骨皮 大腹皮 马兜铃 茯苓 泽漆 百合	咳嗽 浮肿 短气 咳血 咽干 头晕 气喘 妊娠咳嗽 头痛 小便不利
角色0 ： 白芷 防风 羌活 荆芥 川芎 苍术 石膏 菊花 川乌 薄荷  角色1 ： 白芷 川芎 细辛 藁本 羌活 防风 白薇 肉桂 黄连 茴香  角色2 ： 白芷 细辛 川芎 苍术 防风 藁本 羌活 薄荷 甘松 独活  角色3 ： 细辛 川芎 白芷 藁本 蔓荆子 防风 羌活 荆芥 蜂房 生姜	头痛 鼻塞 牙痛 白带 骨痛 浮肿 身痛 无汗 偏头痛 身重
角色0 ： 防风 独活 秦艽 防己 羌活 麻黄 芍药 羚羊角 白芷 川乌  角色1 ： 木瓜 威灵仙 秦艽 牛膝 红花 桂枝 川乌 草乌 续断 制川乌  角色2 ： 防风 羌活 独活 麻黄 防己 细辛 白鲜皮 肉桂 槟榔 鳖甲  角色3 ： 五加 五加皮 牛膝 薏苡仁 独活 羚羊角 酸枣仁 当归 海桐皮 丹参	口噤 四肢麻木 转筋 四肢拘急 项强 角弓反张 头痛 恶寒 舌强 瘫痪
角色0 ： 乳香 没药 血竭 穿山甲 雄黄 安息香 巴豆 肉桂 丁香 苍术  角色1 ： 乳香 没药 血竭 冰片 儿茶 轻粉 海螵蛸 阿魏 胆矾 象皮  角色2 ： 麝香 雄黄 朱砂 轻粉 蟾酥 蜈蚣 巴豆 白矾 犀角 胆矾  角色3 ： 白及 轻粉 蓖麻 白蔹 白芷 松香 五倍子 蓖麻子 麝香 木鳖子	无名肿毒 臁疮 瘰疬 杨梅疮 难产 吐血 白带 腹痛 痫 神昏
角色0 ： 麦冬 沙参 丹参 北沙参 石斛 梨 川贝母 南沙参 牛膝 玄参  角色1 ： 麦冬 玄参 天花粉 知母 黄芩 甘草 橘红 磁石 山豆根 浙贝母  角色2 ： 麦冬 知母 天冬 地骨皮 附子 天门冬 蛇蜕 瓜蒌 川贝母 鳖甲  角色3 ： 桔梗 甘草 玄参 黄芩 知母 荆芥 葱白 麻黄 远志 橘红	口渴 咳嗽 咽干 心烦 瘰疬 烦躁 潮热 气喘 咳痰 胸闷
角色0 ： 附子 细辛 干姜 乌头 秦艽 茵陈 防风 肉桂 三七 麦门冬  角色1 ： 川乌 乌头 草乌 何首乌 赤小豆 天南星 两头尖 白矾 芍药 甘草  角色2 ： 白矾 皂荚 硫黄 猪牙皂 天南星 巴豆 麝香 苍术 知母 花椒  角色3 ： 五灵脂 地龙 没药 乳香 川乌 乌头 草乌 骨碎补 木鳖子 自然铜	口噤 瘫痪 半身不遂 痫 角弓反张 鼻塞 骨痛 鼻衄 腰痛 瘰疬
角色0 ： 白术 茯苓 人参 干姜 前胡 瓜蒌 升麻 肉桂 麝香 胡椒  角色1 ： 白术 甘草 茯苓 人参 陈皮 干姜 炙甘草 乌梅 麦门冬 葛根  角色2 ： 人参 白术 甘草 当归 茯苓 炙甘草 黄芩 陈皮 山药 肉桂  角色3 ： 人参 甘草 白术 茯苓 白芍 芍药 赤小豆 生地黄 黄连 磁石	消瘦 烦躁 壮热 腹痛 自汗 呕吐 口苦 咳嗽 小便不利 舌干
角色0 ： 肉桂 附子 甘草 干姜 炮姜 当归 人参 五灵脂 地龙 穿山甲  角色1 ： 薄荷 荷叶 冰片 樟脑 甘草 黄柏 丹参 莱菔子 辣椒 猪牙皂  角色2 ： 当归 川芎 白术 肉桂 黄芩 人参 木通 郁金 续断 降香  角色3 ： 肉桂 附子 当归 茯苓 诃子 前胡 青皮 茴香 红花 硫黄	腹痛 浮肿 短气 腰痛 畏寒 气喘 头晕 头痛 口苦 腹冷
角色0 ： 白术 附子 茯苓 炙甘草 橘红 半夏 蛤蚧 干漆 白芍 麝香  角色1 ： 甘草 当归 白术 人参 黄连 槟榔 白芍 桂枝 干姜 紫苏叶  角色2 ： 人参 甘草 茯苓 附子 乌梅 芍药 半夏 荆芥 泽泻 玄参  角色3 ： 人参 茯苓 白术 牛膝 炙甘草 大黄 肉桂 木香 荆芥 绿豆	恶风 腹痛 头重 咳嗽 自汗 腰脊痛 小便不利 呕吐 寒战 慢惊
角色0 ： 黄连 大黄 黄柏 黄芩 栀子 青皮 诃子 瓜蒂 木通 石榴  角色1 ： 大黄 黄连 黄芩 栀子 升麻 泽泻 知母 防风 商陆 佩兰  角色2 ： 黄芩 黄柏 黄连 生地黄 升麻 犀角 橘红 连翘 天门冬 绿豆  角色3 ： 黄柏 知母 黄连 栀子 麦门冬 大黄 炙甘草 山药 皂荚 延胡索	烦躁 心烦 盗汗 牙痛 咳嗽 神昏 谵语 呕吐 潮热 不寐
角色0 ： 当归 白芍 芍药 川芎 丹参 玄参 细辛 柏子仁 降香 独活  角色1 ： 当归 白芍 甘草 川芎 生地黄 肉桂 厚朴 葱白 秦艽 薄荷  角色2 ： 当归 白芍 川芎 香附 防风 升麻 干姜 黄柏 蒲公英 巴豆  角色3 ： 当归 川芎 白芍 甘草 茯苓 地骨皮 郁金 木瓜 乌头 木通	腹痛 自汗 头痛 大便下血 盗汗 崩漏 五心烦热 胁痛 心悸 目昏
角色0 ： 半夏 陈皮 白术 炙甘草 苍术 当归 阳起石 防风 滑石 乌梅  角色1 ： 陈皮 甘草 茯苓 半夏 当归 人参 柴胡 白术 寒水石 牵牛  角色2 ： 茯苓 甘草 白术 半夏 炙甘草 防风 芍药 干姜 巴豆 紫河车  角色3 ： 人参 茯苓 甘草 黄芩 附子 柴胡 麦门冬 川芎 泽兰 白术	呕吐 咳嗽 腹痛 反胃 噎膈 面色青 舌苔白 气喘 小便不利 多唾
角色0 ： 生姜 大枣 桂枝 葱白 人参 厚朴 薤白 紫苏子 槐花 半夏  角色1 ： 生姜 半夏 厚朴 葱白 附子 大枣 陈皮 甘草 青礞石 橘红  角色2 ： 生姜 厚朴 半夏 大枣 葱白 小麦 麝香 虎杖 母丁香 黄芩  角色3 ： 生姜 半夏 厚朴 大枣 紫苏叶 干姜 高良姜 白茅根 瓜蒌 诃子	呕吐 恶寒 头痛 咳嗽 鼻塞 恶寒发热 反胃 心悸 恶风 不射精
角色0 ： 甘草 麻黄 桂枝 黄芩 郁金 升麻 柴胡 知母 豆蔻 厚朴  角色1 ： 麻黄 防风 细辛 甘草 干姜 苍术 柴胡 五味子 黄芩 陈皮  角色2 ： 甘草 麻黄 桔梗 枳壳 桂枝 僵蚕 乌梅 当归 葛根 枸杞子  角色3 ： 甘草 麻黄 细辛 防风 桂枝 防己 远志 胡椒 郁金 瓜蒂	恶寒 咳嗽 头痛 无汗 气喘 浮肿 鼻塞 恶寒发热 腹痛 身痛
角色0 ： 鹿茸 肉苁蓉 菟丝子 蛇床子 覆盆子 补骨脂 枸杞子 巴戟天 阳起石 淫羊藿  角色1 ： 杜仲 牛膝 续断 狗脊 石斛 菟丝子 虎骨 鳖甲 蛇蜕 干漆  角色2 ： 石斛 牛膝 五味子 山茱萸 菟丝子 杜仲 肉苁蓉 巴戟天 远志 磁石  角色3 ： 牛膝 杜仲 山药 山茱萸 枸杞子 五味子 菟丝子 肉苁蓉 熟地黄 补骨脂	腰痛 耳聋 目昏 头晕 不孕 腰膝无力 小便频数 胎动不安 短气 白带
角色0 ： 人参 甘草 茯苓 柴胡 泽泻 白术 防己 炮姜 阿胶 寒水石  角色1 ： 茯苓 白术 人参 甘草 干姜 附子 黄连 绿豆 小麦 小蓟  角色2 ： 白术 甘草 茯苓 人参 附子 干姜 石斛 川芎 旋覆花 竹沥  角色3 ： 白术 甘草 茯苓 当归 人参 柴胡 枳实 延胡索 陈皮 鬼箭羽	少气 背痛 腹痛 壮热 小便不利 短气 自汗 咳嗽 呕吐 目昏
角色0 ： 枳壳 桔梗 前胡 瓜蒌 茯苓 薄荷 大黄 大腹皮 鳖甲 赤芍  角色1 ： 枳壳 前胡 桔梗 甘草 旋覆花 薄荷 橘红 连翘 浙贝母 麻黄  角色2 ： 桔梗 半夏 前胡 枳壳 紫苏叶 薄荷 槐角 枳实 薤白 石膏  角色3 ： 桔梗 前胡 枳壳 半夏 旋覆花 黄芩 川贝母 法半夏 天南星 高良姜	咳嗽 壮热 胸闷 呕吐 呵欠 喷嚏 脱肛 咽干 胁痛 头痛
角色0 ： 麝香 雄黄 朱砂 牛黄 青礞石 硼砂 天竺黄 安息香 大豆 地龙  角色1 ： 天竺黄 牛黄 朱砂 琥珀 钩藤 胆南星 雄黄 牛胆 冰片 天麻  角色2 ： 冰片 珍珠 牛黄 硼砂 麝香 琥珀 朱砂 熊胆 玄明粉 炉甘石  角色3 ： 朱砂 麝香 雄黄 牛黄 蟾酥 全蝎 巴豆 防风 绿豆 首乌藤	痫 急惊 神昏 发狂 瘰疬 腹痛 慢惊 心烦 目昏 难产
角色0 ： 葛根 石膏 麻黄 黄芩 甘草 栀子 白芍 山药 荆芥 梨  角色1 ： 石膏 寒水石 黄芩 滑石 甘草 葛根 地骨皮 茯苓 前胡 鸡子  角色2 ： 石膏 知母 麻黄 葛根 赤芍 麦门冬 防己 郁金 鳖甲 瓜蒌  角色3 ： 石膏 升麻 葛根 柴胡 知母 寒水石 葱白 竹沥 桂枝 麻黄	头痛 壮热 口渴 咽干 心烦 谵语 自汗 恶寒 发狂 牙痛
角色0 ： 荆芥 连翘 薄荷 蝉蜕 防风 紫草 僵蚕 桔梗 夏枯草 荷叶  角色1 ： 桔梗 益智 益智仁 薄荷 连翘 前胡 威灵仙 漏芦 茯苓 大黄  角色2 ： 连翘 金银花 天花粉 玄参 板蓝根 土茯苓 皂角刺 蒲公英 大青叶 薄荷  角色3 ： 牛蒡 牛蒡子 连翘 荆芥 桔梗 薄荷 淡豆豉 紫草 马勃 金银花	瘰疬 麻疹 丹毒 杨梅疮 咳嗽 谵语 头痛 小便频数 遗尿 痄腮
角色0 ： 甘草 黄芩 人参 茯苓 柴胡 土茯苓 防风 三七 乌药 麦门冬  角色1 ： 甘草 黄芩 大黄 柴胡 芍药 苍术 连翘 白茅根 黄连 射干  角色2 ： 甘草 黄芩 柴胡 枳壳 芍药 知母 当归 生地黄 竹沥 半夏  角色3 ： 黄芩 柴胡 郁金 枳壳 大黄 甘草 生地黄 栀子 陈皮 川芎	舌干 口苦 咳嗽 头痛 气喘 寒热往来 腹痛 神昏 谵语 壮热
角色0 ： 三棱 莪术 青皮 干漆 牵牛 阿魏 五灵脂 姜黄 槟榔 芫花  角色1 ： 木香 槟榔 沉香 青木香 牛膝 五味子 陈皮 牵牛 石菖蒲 五倍子  角色2 ： 三棱 莪术 槟榔 青皮 木香 萝卜 牵牛 香附 白术 甘草  角色3 ： 巴豆 丁香 巴豆霜 斑蝥 五灵脂 猪牙皂 硼砂 青皮 槟榔 木香	腹痛 腹满 消瘦 积滞 瘰疬 里急后重 壮热 干呕 呃逆 呕吐
角色0 ： 芍药 赤芍 当归 川芎 甘草 黄芩 升麻 诃子 延胡索 桔梗  角色1 ： 赤芍 芍药 黄芩 附子 白芍 川芎 甘草 升麻 桑枝 仙鹤草  角色2 ： 赤芍 芍药 当归 甘草 连翘 白芷 黄连 石膏 大豆 桔梗  角色3 ： 芍药 赤芍 当归 牵牛 茜草 阿魏 地骨皮 乌药 青蒿 枸杞子	鼻衄 四肢疼痛 壮热 腹痛 吐血 胁痛 谵语 黄汗 崩中 舌干
角色0 ： 远志 石菖蒲 五味子 磁石 柏子仁 龙齿 地骨皮 琥珀 紫石英 山茱萸  角色1 ： 麦门冬 生地黄 五味子 天门冬 熟地黄 人参 黄连 白矾 青黛 百部  角色2 ： 远志 酸枣仁 柏子仁 石菖蒲 丹参 琥珀 龙眼 龙眼肉 龙齿 紫石英  角色3 ： 人参 远志 五味子 茯苓 麦门冬 丹参 柏子仁 知母 赤芍 磁石	健忘 耳聋 短气 盗汗 自汗 心烦 痫 多梦 心悸 咳嗽
角色0 ： 甘草 人参 白术 炙甘草 半夏 泽泻 五灵脂 葱白 升麻 生姜  角色1 ： 甘草 人参 茯苓 泽泻 枳壳 百合 麻黄 香附 羌活 橘红  角色2 ： 甘草 茯苓 人参 延胡索 大枣 五味子 当归 枳实 斑蝥 辛夷  角色3 ： 白术 茯苓 干姜 甘草 大枣 当归 细辛 五味子 茴香 麦门冬	少气 咳嗽 气喘 腹痛 烦躁 鼻干 面色青 小便不利 呕吐 壮热
