角色0 ： 石膏 甘草 麦门冬 知母 人参 葛根 黄芩 茯苓 地骨皮 栀子  角色1 ： 连翘 防风 牛蒡 桔梗 荆芥 牛蒡子 甘草 木通 赤芍 黄芩  角色2 ： 升麻 犀角 玄参 大黄 甘草 木香 射干 黄芩 羚羊角 连翘  角色3 ： 黄连 甘草 滑石 寒水石 朱砂 冰片 牛黄 青黛 薄荷 郁金	烦躁 壮热 头痛 谵语 丹毒 心烦 麻疹 舌干 瘰疬 口渴
角色0 ： 黄连 黄芩 黄柏 大黄 栀子 当归 枳壳 木香 甘草 槟榔  角色1 ： 藜 蒺藜 防风 菊花 车前 车前子 青葙 青葙子 木贼 决明子  角色2 ： 枳实 半夏 甘草 茯苓 陈皮 生姜 竹茹 橘红 桔梗 人参  角色3 ： 泽泻 茯苓 白术 猪苓 苍术 陈皮 甘草 厚朴 茵陈 木通	呕吐 目昏 小便不利 烦躁 腹痛 里急后重 头痛 流泪 口渴 心下痞
角色0 ： 远志 人参 酸枣仁 柏子仁 石菖蒲 茯苓 当归 五味子 甘草 山药  角色1 ： 麦冬 甘草 白芍 玄参 天冬 当归 沙参 桔梗 黄芩 茯苓  角色2 ： 防风 阿胶 甘草 杏仁 茯苓 杏 人参 当归 犀角 白术  角色3 ： 鳖甲 柴胡 木香 人参 甘草 秦艽 茯苓 乌梅 槟榔 知母	心烦 健忘 烦躁 盗汗 咳嗽 口苦 口渴 潮热 舌干 吐血
角色0 ： 桑 槟榔 茯苓 郁李 郁李仁 木通 木香 防己 枳壳 大黄  角色1 ： 芍药 赤芍 黄芩 甘草 柴胡 升麻 石膏 麦门冬 前胡 葛根  角色2 ： 杏 杏仁 麻黄 甘草 紫菀 防风 桔梗 石膏 茯苓 当归  角色3 ： 生姜 甘草 半夏 人参 白术 大枣 细辛 干姜 桂枝 茯苓	咳嗽 头痛 浮肿 壮热 气喘 恶寒 小便不利 呕吐 短气 腹满
角色0 ： 苦参 藜 蒺藜 防风 白芷 荆芥 菊花 威灵仙 甘草 苍耳  角色1 ： 丹参 牛膝 川芎 郁金 红花 赤芍 黄芪 地龙 当归 三七  角色2 ： 龙齿 牛黄 人参 钩藤 犀角 甘草 大黄 石膏 升麻 蛇蜕  角色3 ： 金银花 当归 连翘 甘草 茯苓 土茯苓 天花粉 防风 夏枯草 皂角刺	痫 瘰疬 杨梅疮 皮肤瘙痒 头痛 心烦 壮热 胸闷 鼻衄 烦躁
角色0 ： 薄荷 黄芩 连翘 栀子 甘草 桔梗 荆芥 大黄 防风 石膏  角色1 ： 牛蒡 连翘 牛蒡子 薄荷 金银花 甘草 玄参 荆芥 桔梗 竹叶  角色2 ： 桑 桑白皮 枇杷 枇杷叶 桑叶 麦冬 百部 甘草 知母 桔梗  角色3 ： 杏 杏仁 桔梗 前胡 陈皮 甘草 枳壳 苦杏仁 黄芩 半夏	咳嗽 头痛 口渴 恶寒 鼻塞 麻疹 大便秘结 咽干 烦躁 气喘
角色0 ： 牡蛎 龙骨 桑 茯苓 人参 桑螵蛸 鹿角 山药 菟丝子 白芍  角色1 ： 车前 车前子 木通 滑石 瞿麦 甘草 茯苓 泽泻 当归 猪苓  角色2 ： 牡丹 牡丹皮 茯苓 泽泻 山药 当归 山茱萸 熟地黄 生地黄 甘草  角色3 ： 黄芩 大黄 栀子 柴胡 甘草 茵陈 龙胆 升麻 黄连 知母	小便不通 盗汗 发黄 小便不利 烦躁 心烦 壮热 遗尿 白带 自汗
角色0 ： 芥子 白芥 白芥子 半夏 当归 甘草 陈皮 柴胡 茯苓 肉桂  角色1 ： 黄连 胡黄连 芦荟 麝香 使君子 芜荑 青黛 木香 朱砂 雄黄  角色2 ： 肉苁蓉 牛膝 菟丝子 五味子 茯苓 杜仲 人参 石斛 山茱萸 远志  角色3 ： 茴香 附子 沉香 木香 小茴香 川楝子 肉桂 丁香 桃 藜	腰痛 疳积 耳聋 腹痛 消瘦 盗汗 手足厥冷 壮热 目昏 小便频数
角色0 ： 乳香 麝香 雄黄 没药 朱砂 冰片 血竭 轻粉 蟾酥 硼砂  角色1 ： 丁香 木香 沉香 檀香 细辛 白芷 薄荷 藿香 香附 冰片  角色2 ： 牛黄 朱砂 天竺黄 琥珀 麝香 雄黄 冰片 僵蚕 钩藤 天麻  角色3 ： 附子 白附子 全蝎 僵蚕 天麻 天南星 麝香 防风 朱砂 半夏	慢惊 痫 急惊 咳嗽 臁疮 神昏 腹痛 呕吐 无名肿毒 头痛
角色0 ： 杜仲 枸杞子 菟丝子 牛膝 熟地黄 山药 当归 五味子 鹿角 鹿茸  角色1 ： 神曲 山楂 麦芽 陈皮 砂仁 半夏 香附 白术 茯苓 厚朴  角色2 ： 山药 党参 茯苓 白术 甘草 陈皮 芡实 黄芪 莲子 麦冬  角色3 ： 人参 甘草 白芍 白术 肉桂 当归 炙甘草 川芎 茯苓 附子	自汗 腹痛 食欲不振 腰痛 呕吐 头晕 心悸 盗汗 吞酸 腹泻
角色0 ： 竹叶 淡竹 甘草 淡竹叶 生地黄 麦门冬 生姜 人参 小麦 黄芩  角色1 ： 紫菀 款冬花 杏 杏仁 桑 甘草 五味子 桑白皮 人参 百合  角色2 ： 乌梅 诃子 薄荷 木通 枳壳 厚朴 陈皮 甘草 砂仁 槟榔  角色3 ： 甘草 半夏 川贝母 陈皮 桔梗 橘红 杏仁 杏 麻黄 紫苏子	咳嗽 气喘 吐血 咽干 短气 呕吐 心烦 口渴 干呕 自汗
角色0 ： 白芷 川芎 当归 桔梗 白芍 乌药 甘草 麻黄 芍药 干姜  角色1 ： 陈皮 苍术 厚朴 甘草 半夏 茯苓 香附 枳壳 白术 砂仁  角色2 ： 羌活 防风 柴胡 川芎 甘草 荆芥 桔梗 独活 前胡 枳壳  角色3 ： 藿香 木香 厚朴 茯苓 甘草 神曲 广藿香 木瓜 槟榔 大腹皮	头痛 恶寒 呕吐 腹痛 咳嗽 恶心 无汗 浮肿 身痛 转筋
角色0 ： 芍药 当归 甘草 人参 赤芍 干姜 茯苓 附子 大黄 吴茱萸  角色1 ： 黄芩 柴胡 甘草 半夏 枳壳 人参 栀子 黄连 青皮 薄荷  角色2 ： 阿胶 当归 续断 艾叶 甘草 杜仲 地榆 桑 蒲黄 桑寄生  角色3 ： 白芍 川芎 白术 当归 茯苓 陈皮 香附 人参 甘草 熟地黄	腹痛 吐血 胎动不安 胁痛 便血 白带 寒热往来 崩漏 鼻衄 口苦
角色0 ： 川芎 当归 香附 红花 茴香 白芍 莪术 木香 延胡索 三棱  角色1 ： 赤石脂 龙骨 当归 干姜 黄连 禹余粮 艾叶 地榆 阿胶 牡蛎  角色2 ： 芍药 牡丹 当归 牡丹皮 赤芍 蒲黄 牛膝 延胡索 大黄 桃  角色3 ： 细辛 干姜 附子 防风 人参 白术 甘草 白芷 茯苓 石斛	腹痛 白带 崩中 赤白带 漏下 里急后重 脱肛 心烦 崩漏 吐血
角色0 ： 桃 桃仁 当归 红花 大黄 甘草 赤芍 柴胡 枳壳 川芎  角色1 ： 杏 杏仁 麝香 丁香 白芷 附子 硫黄 木香 松香 乳香  角色2 ： 乳香 没药 五灵脂 当归 地龙 川乌 草乌 骨碎补 牛膝 血竭  角色3 ： 川芎 当归 茯苓 香附 白术 白芍 沉香 甘草 人参 砂仁	腹痛 白带 赤白带 浮肿 腰痛 瘰疬 瘫痪 半身不遂 难产 臁疮
角色0 ： 地骨皮 柴胡 人参 桑 鳖甲 甘草 桔梗 知母 茯苓 芍药  角色1 ： 麦门冬 人参 五味子 甘草 茯苓 白术 当归 远志 陈皮 芍药  角色2 ： 白芍 当归 黄柏 生地黄 知母 川芎 熟地黄 芍药 天门冬 牛膝  角色3 ： 女贞 女贞子 桑 何首乌 枸杞子 菟丝子 桑椹 黄芪 当归 熟地黄	潮热 咳嗽 盗汗 头晕 心烦 短气 烦躁 心悸 少气 咽干
角色0 ： 白芷 当归 大黄 草乌 黄柏 穿山甲 赤芍 白及 蜈蚣 乳香  角色1 ： 木香 三棱 牵牛 大黄 莪术 巴豆 芫花 槟榔 甘遂 丁香  角色2 ： 干姜 吴茱萸 乌头 细辛 附子 桔梗 人参 大黄 茯苓 川乌  角色3 ： 巴豆 雄黄 麝香 朱砂 巴豆霜 杏仁 杏 轻粉 牛黄 半夏	瘰疬 腹痛 痫 无名肿毒 小便不通 积滞 浮肿 咳嗽 恶心 腹满
角色0 ： 茯苓 前胡 枳壳 人参 半夏 甘草 桔梗 白术 旋覆花 木香  角色1 ： 升麻 柴胡 当归 甘草 羌活 苍术 黄柏 炙甘草 黄芩 黄连  角色2 ： 防风 独活 麻黄 甘草 附子 人参 白术 芍药 防己 当归  角色3 ： 川芎 细辛 羌活 防风 白芷 甘草 荆芥 藁本 蔓荆子 菊花	头痛 口噤 鼻塞 恶风 目昏 恶寒 壮热 项强 自汗 咳嗽
角色0 ： 五加 五加皮 牛膝 防风 当归 羌活 独活 薏苡仁 茯苓 丹参  角色1 ： 川乌 草乌 白芷 川芎 细辛 麻黄 当归 防风 甘草 荆芥  角色2 ： 牛膝 杜仲 独活 木瓜 当归 续断 秦艽 羌活 威灵仙 桂枝  角色3 ： 附子 白附子 天南星 天麻 麝香 僵蚕 牛黄 麻黄 半夏 防风	腰痛 半身不遂 头痛 口噤 瘫痪 四肢麻木 目昏 角弓反张 骨痛 痫
角色0 ： 甘草 人参 茯苓 半夏 白术 藿香 砂仁 陈皮 丁香 益智  角色1 ： 干姜 厚朴 生姜 附子 白术 甘草 人参 吴茱萸 高良姜 茯苓  角色2 ： 青皮 木香 三棱 槟榔 香附 莪术 陈皮 枳壳 砂仁 厚朴  角色3 ： 豆蔻 木香 肉豆蔻 丁香 白豆蔻 沉香 草豆蔻 槟榔 诃子 附子	呕吐 腹痛 恶心 肠鸣 吞酸 转筋 腹满 腹冷 呃逆 干呕
