甘草 白术 茯苓 陈皮 人参 木瓜 乌梅 木香 半夏 芥子	腹痛 转筋 里急后重 上吐下泻 呃逆 腹泻 畏寒 口淡 臂痛 烦躁
防风 独活 羌活 菊花 麻黄 细辛 羚羊角 藜 蒺藜 秦艽	目昏 口噤 项强 恶风 皮肤瘙痒 流泪 角弓反张 四肢拘急 舌强 头重
陈皮 神曲 厚朴 苍术 香附 砂仁 山楂 藿香 麦芽 青皮	呕吐 恶心 吞酸 嘈杂 嗳气 胃痛 呃逆 食欲不振 腹泻 大便溏
川芎 白芷 防风 羌活 细辛 荆芥 苍术 藁本 薄荷 麻黄	头痛 鼻塞 恶寒 无汗 头昏 背痛 喷嚏 恶风 项强 偏头痛
当归 芍药 阿胶 龙骨 生地黄 白芍 赤石脂 黄连 地榆 蒲黄	吐血 便血 崩中 漏下 鼻衄 脱肛 崩漏 大便下血 尿血 咳血
何首乌 女贞 黄芪 党参 女贞子 山药 枸杞子 鹿角 熟地黄 黄精	头晕 心悸 头昏 健忘 胸闷 食欲不振 多梦 疲乏 遗尿 须发早白
生姜 半夏 厚朴 甘草 人参 大枣 白术 枳实 竹茹 茯苓	呕吐 干呕 腹满 短气 心下痞 恶心 反胃 小儿呕吐 目昏 脏躁
牛膝 杜仲 菟丝子 山药 肉苁蓉 续断 石斛 山茱萸 附子 五味子	腰痛 耳聋 小便频数 腰重 腰膝无力 目昏 少气 半身不遂 遗尿 腹冷
柴胡 甘草 鳖甲 知母 芍药 人参 地骨皮 黄芩 秦艽 麦门冬	心烦 潮热 盗汗 寒热往来 五心烦热 四肢疼痛 消瘦 目昏 口渴 产后血崩
杏 杏仁 麻黄 甘草 紫菀 桔梗 瓜蒌 款冬花 紫苏叶 橘红	咳嗽 气喘 咳痰 喉痒 无汗 杨梅疮 鼻干 漏睛 里急后重 腹中痞块
甘草 石膏 黄芩 葛根 芍药 赤芍 柴胡 麻黄 升麻 葱白	头痛 壮热 鼻干 无汗 头热 偏头痛 足颤 胎动不安 干呕 但热不寒
枳壳 甘草 桔梗 半夏 前胡 茯苓 陈皮 旋覆花 橘红 大腹皮	咳嗽 头痛 目昏 胁痛 鼻塞 多唾 恶心 舌肿 身痛 寒热往来
木香 丁香 豆蔻 沉香 肉豆蔻 藿香 砂仁 益智 白豆蔻 诃子	呕吐 恶心 腹痛 肠鸣 吞酸 反胃 口臭 小儿呕吐 足热 胸闷
甘草 白术 当归 人参 茯苓 白芍 桂枝 炙甘草 芍药 柴胡	恶寒 自汗 恶风 无汗 恶寒发热 身痛 身重 呵欠 大便溏 壮热
槟榔 木香 三棱 青皮 大黄 巴豆 莪术 牵牛 枳壳 郁李仁	浮肿 积滞 腹满 疳积 腹痛 消瘦 气喘 大便秘结 胁痛 耳痛
附子 天麻 僵蚕 白附子 全蝎 天南星 麝香 朱砂 白矾 雄黄	慢惊 痫 神昏 口噤 半身不遂 急惊 瘫痪 角弓反张 舌强 四肢拘急
连翘 薄荷 荆芥 桔梗 玄参 牛蒡 竹叶 天花粉 牛蒡子 金银花	口渴 麻疹 丹毒 杨梅疮 咽干 谵语 头痛 烦躁 胎毒 神昏
甘草 人参 茯苓 白术 半夏 橘红 麦门冬 当归 陈皮 枳壳	口苦 短气 舌干 心烦 潮热 身重 目昏 恶心 但热不寒 寒热往来
干姜 附子 吴茱萸 肉桂 当归 白术 细辛 人参 硫黄 乌头	腹痛 腹冷 手足厥冷 面色青 短气 背痛 肠鸣 少气 转筋 寒战
桑 桔梗 桑白皮 麦冬 知母 紫菀 五味子 麦门冬 百合 款冬花	咳嗽 气喘 咽干 咳血 妊娠咳嗽 咳痰 面色白 心烦 麻疹 背冷
乳香 没药 川乌 草乌 白芷 轻粉 五灵脂 血竭 乌头 麝香	瘰疬 臁疮 无名肿毒 瘫痪 半身不遂 湿疮 杨梅疮 阴疮 四肢麻木 胃痛
当归 白芍 川芎 香附 白术 熟地黄 阿胶 乌药 党参 益母草	白带 赤白带 胎动不安 崩漏 不孕 腹痛 胎漏 闭经 月经过多 经行腹痛
茯苓 木通 泽泻 滑石 车前 车前子 猪苓 甘草 防己 瞿麦	小便不利 小便不通 浮肿 难产 身重 尿血 乳汁不行 妊娠小便不通 尿痛 胞衣不下
人参 茯苓 远志 五味子 麦门冬 山药 麦冬 酸枣仁 石菖蒲 牡蛎	盗汗 自汗 健忘 少气 心烦 不寐 消瘦 远视 畏寒 言语错乱
升麻 犀角 甘草 麦门冬 大黄 黄芩 石膏 栀子 玄参 羚羊角	烦躁 壮热 发狂 心烦 咽喉痛 舌干 黄汗 咽干 舌肿 口中生疮
麝香 朱砂 牛黄 雄黄 冰片 青黛 琥珀 天竺黄 黄连 珍珠	痫 神昏 急惊 壮热 慢惊 口臭 小儿发热 流泪 胎毒 弄舌
甘草 桔梗 黄芩 麦冬 连翘 葛根 枳壳 薄荷 菊花 茯苓	吐血 咽干 口渴 鼻衄 胸闷 舌苔白 呃逆 腹泻 肥胖 舌苔白腻
川乌 麝香 细辛 没药 丁香 木香 大黄 乳香 当归 防风	牙痛 耳聋 骨痛 脱肛 反胃 噎膈 四肢麻木 粉刺 关节疼痛 难产
黄连 黄芩 大黄 黄柏 栀子 龙胆 茵陈 苦参 郁金 枳实	烦躁 谵语 发黄 大便秘结 壮热 里急后重 小便黄赤 发狂 舌苔黄 头汗
当归 桃 桃仁 芍药 赤芍 红花 牡丹 牡丹皮 延胡索 川芎	腹痛 胁痛 难产 四肢疼痛 胸痛 恶露不下 胞衣不下 产后腹痛 心烦 少腹痛
