麝香 朱砂 雄黄 牛黄 冰片 琥珀 青黛 天竺黄 轻粉 郁金	咳嗽 腹痛 头痛 呕吐 烦躁 痫 壮热 恶心 瘰疬 慢惊
当归 川芎 白芍 芍药 阿胶 香附 牡丹 生地黄 牡丹皮 蒲黄	腹痛 咳嗽 头痛 呕吐 白带 心烦 赤白带 烦躁 浮肿 腰痛
石膏 升麻 甘草 犀角 麦门冬 黄芩 葛根 羚羊角 芍药 柴胡	咳嗽 头痛 腹痛 呕吐 壮热 烦躁 痫 心烦 恶寒 潮热
黄芩 黄连 大黄 栀子 黄柏 甘草 柴胡 龙胆 枳实 石膏	咳嗽 头痛 腹痛 呕吐 壮热 烦躁 心烦 瘰疬 痫 恶心
木香 丁香 豆蔻 沉香 砂仁 肉豆蔻 茴香 香附 青皮 乌药	腹痛 咳嗽 呕吐 头痛 恶心 烦躁 浮肿 壮热 目昏 盗汗
甘草 茯苓 人参 半夏 陈皮 白术 竹茹 乌梅 桔梗 麦门冬	咳嗽 腹痛 呕吐 头痛 壮热 烦躁 痫 恶心 心烦 目昏
杏 杏仁 桑 紫菀 麻黄 桔梗 桑白皮 五味子 款冬花 百合	咳嗽 头痛 呕吐 腹痛 壮热 烦躁 浮肿 气喘 鼻塞 心烦
牛膝 五味子 杜仲 远志 山药 龙骨 牡蛎 石斛 山茱萸 续断	咳嗽 腹痛 头痛 盗汗 目昏 腰痛 白带 呕吐 心烦 赤白带
槟榔 木香 大黄 巴豆 三棱 牵牛 黄连 莪术 青皮 藜	咳嗽 腹痛 呕吐 头痛 浮肿 壮热 烦躁 痫 恶心 瘰疬
防风 羌活 川芎 白芷 细辛 独活 苍术 荆芥 麻黄 菊花	咳嗽 头痛 腹痛 呕吐 壮热 目昏 烦躁 瘰疬 痫 浮肿
附子 天麻 僵蚕 白附子 全蝎 天南星 防风 乌头 川乌 麝香	咳嗽 头痛 腹痛 呕吐 痫 烦躁 壮热 恶心 目昏 慢惊
薄荷 连翘 桔梗 荆芥 玄参 牛蒡 麦冬 黄芩 天花粉 金银花	咳嗽 头痛 腹痛 呕吐 烦躁 壮热 恶寒 口渴 心烦 咽干
陈皮 厚朴 神曲 藿香 苍术 砂仁 山楂 枳壳 香附 麦芽	咳嗽 腹痛 头痛 呕吐 烦躁 浮肿 恶心 恶寒 壮热 口渴
干姜 白术 人参 茯苓 附子 吴茱萸 厚朴 甘草 细辛 肉桂	咳嗽 腹痛 头痛 呕吐 恶心 壮热 心烦 浮肿 烦躁 恶寒
茯苓 甘草 木通 泽泻 滑石 车前 白术 防己 车前子 猪苓	咳嗽 腹痛 呕吐 头痛 烦躁 壮热 浮肿 心烦 恶寒 恶心
当归 桃 没药 桃仁 乳香 红花 赤芍 白芷 肉桂 草乌	腹痛 咳嗽 头痛 呕吐 瘰疬 腰痛 烦躁 浮肿 壮热 心烦
甘草 人参 当归 白术 茯苓 白芍 芍药 川芎 炙甘草 干姜	咳嗽 腹痛 头痛 呕吐 烦躁 壮热 心烦 痫 恶心 潮热
柴胡 甘草 芍药 知母 地骨皮 赤芍 鳖甲 人参 麦门冬 枳壳	咳嗽 头痛 腹痛 呕吐 烦躁 心烦 壮热 盗汗 潮热 目昏
当归 麦冬 白芍 山药 茯苓 五味子 党参 远志 黄芪 熟地黄	头晕 健忘 心悸 咳嗽 腹痛 头痛 烦躁 心烦 呕吐 盗汗
甘草 半夏 生姜 前胡 桂枝 枳壳 麻黄 桔梗 大枣 旋覆花	咳嗽 腹痛 头痛 呕吐 壮热 烦躁 心烦 浮肿 恶寒 痫
