黄芩 大黄 栀子 黄连 黄柏 茵陈 郁金 芥子 柴胡 枳实	谵语 大便秘结 发黄 发狂 烦躁 舌苔黄 小便黄赤 麻疹 肥胖 胁痛
丁香 木香 豆蔻 肉豆蔻 沉香 胡椒 白豆蔻 草豆蔻 高良姜 诃子	肠鸣 呕吐 恶心 腹痛 吞酸 积滞 食欲不振 脱肛 足颤 胸闷
石膏 葛根 黄芩 升麻 竹叶 甘草 知母 淡竹 淡竹叶 麦门冬	头痛 壮热 大便下血 唇肿 烦躁 少气 头昏 胸闷 头晕 身重
木香 黄连 槟榔 枳壳 青皮 胡黄连 大黄 芦荟 使君子 芜荑	腹痛 疳积 消瘦 里急后重 口臭 积滞 脱肛 鼻痒 不孕 口中生疮
桔梗 甘草 枳壳 半夏 橘红 前胡 枇杷 枇杷叶 川贝母 瓜蒌	咳嗽 干呕 胸闷 咳痰 四肢疼痛 鼻塞 胃痛 阴痒 臂痛 目昏
白芷 川芎 细辛 防风 藁本 羌活 荆芥 薄荷 苍术 蔓荆子	头痛 鼻塞 头昏 偏头痛 目昏 项强 口渴 口臭 积滞 四肢疼痛
防风 羌活 川芎 苍术 白芷 独活 细辛 荆芥 麻黄 桔梗	恶寒 头痛 无汗 身痛 恶寒发热 针眼 神昏 瘫痪 低热 牙龈溃烂
山药 茯苓 牡蛎 白术 人参 龙骨 益智 肉桂 益智仁 五味子	盗汗 自汗 遗尿 小便频数 畏寒 头晕 小儿遗尿 心悸 脏躁 小儿厌食
附子 防风 独活 细辛 乌头 麻黄 川乌 天南星 白附子 羌活	口噤 半身不遂 项强 角弓反张 四肢拘急 舌强 四肢强直 浮肿 背痛 自汗
白术 茯苓 半夏 人参 陈皮 甘草 乌梅 生姜 防风 当归	呕吐 腹满 恶心 大便溏 胁痛 头昏 头痛 臂痛 寒战 脱肛
白术 甘草 茯苓 人参 当归 陈皮 炙甘草 半夏 柴胡 苍术	自汗 短气 身重 恶风 头重 小便黄赤 口淡 言语错乱 头晕 恶寒
柴胡 甘草 鳖甲 地骨皮 知母 茯苓 秦艽 人参 青蒿 白术	潮热 盗汗 寒热往来 消瘦 但热不寒 谵语 口苦 头晕 少气 舌卷
大黄 升麻 玄参 黄芩 黄连 黄柏 连翘 白矾 白芷 皂荚	瘰疬 牙痛 咽喉痛 舌肿 粉刺 腹满 丹毒 舌干 耳痛 胞衣不下
乳香 没药 冰片 麝香 轻粉 雄黄 血竭 朱砂 硼砂 珍珠	臁疮 无名肿毒 瘰疬 牙痛 杨梅疮 湿疮 流泪 舌肿 阴疮 胎毒
当归 芍药 生地黄 牡丹 牡丹皮 赤芍 蒲黄 熟地黄 白芍 阿胶	吐血 鼻衄 咳血 便血 少气 口臭 咽喉痛 食欲不振 耳内流脓 转筋
薄荷 连翘 荆芥 牛蒡 牛蒡子 金银花 荷叶 桔梗 天花粉 防风	麻疹 鼻塞 丹毒 口渴 杨梅疮 谵语 咳嗽 痄腮 小儿丹毒 寒战
杏仁 杏 紫菀 桑 款冬花 桑白皮 五味子 百合 百部 苦杏仁	咳嗽 气喘 喉痒 妊娠咳嗽 鼻衄 臁疮 身重 目昏 小便黄赤 难产
甘草 桔梗 枳壳 陈皮 茯苓 半夏 前胡 旋覆花 苍术 柴胡	咳嗽 头痛 阴疮 喷嚏 舌苔黄 壮热 骨痛 腰重 神昏 鼻衄
半夏 陈皮 人参 白术 生姜 甘草 茯苓 枳实 厚朴 竹茹	腹满 干呕 呃逆 呕吐 舌苔白 心下痞 口淡 多唾 舌苔白腻 头重
杏 杏仁 甘草 麻黄 桔梗 前胡 半夏 枳壳 旋覆花 橘红	咳嗽 气喘 耳聋 尿痛 寒热往来 腹痛 胃痛 壮热 咳血 小儿痞块
甘草 柴胡 人参 黄芩 当归 枳壳 麦门冬 芍药 黄连 炙甘草	口苦 舌干 胁痛 咽干 耳聋 头重 胸痛 鼻衄 反胃 阴痛
神曲 青皮 陈皮 三棱 山楂 莪术 香附 砂仁 麦芽 枳实	吞酸 积滞 恶心 嘈杂 嗳气 食欲不振 胃痛 呕吐 胸闷 腹泻
甘草 麻黄 生姜 桂枝 大枣 石膏 芍药 葱白 葛根 白芍	头痛 恶寒 恶风 无汗 项强 月经过多 舌肿 头汗 丹毒 胁痛
芍药 赤芍 甘草 黄芩 柴胡 当归 枳壳 大黄 升麻 白术	壮热 头痛 四肢疼痛 寒热往来 腹满 弄舌 干呕 黄汗 浮肿 大便下血
人参 麦门冬 茯苓 甘草 五味子 天门冬 生地黄 远志 大枣 半夏	短气 少气 吐血 背痛 不寐 足热 神昏 胸闷 咳嗽 面色白
当归 白芍 川芎 香附 熟地黄 阿胶 芍药 益母草 砂仁 陈皮	腹痛 胎动不安 不孕 胎漏 头昏 头晕 月经过多 里急后重 吐血 带状疱疹
当归 阿胶 白芍 赤石脂 龙骨 艾叶 地榆 芍药 牡蛎 干姜	崩漏 便血 崩中 漏下 脱肛 尿血 大便下血 吐血 腹痛 胎漏
黄芩 大黄 栀子 黄连 犀角 升麻 石膏 寒水石 黄柏 龙胆	烦躁 壮热 谵语 胎毒 鼻干 发狂 面色青 腹满 唇肿 心下痞
半夏 生姜 厚朴 甘草 茯苓 白术 陈皮 人参 枳实 干姜	呕吐 恶心 小儿呕吐 心下痞 呵欠 身痛 浮肿 妊娠呕吐 胃痛 目昏
当归 白术 茯苓 甘草 人参 白芍 芍药 川芎 炙甘草 肉桂	心烦 五心烦热 咽干 潮热 腹痛 臂痛 头摇 善怒 产后血崩 面色青
甘草 干姜 人参 白术 当归 乌梅 附子 茯苓 诃子 罂粟壳	腹痛 里急后重 腹泻 产后腹痛 多唾 头昏 脱肛 臂痛 善惊 漏睛
僵蚕 天麻 全蝎 白附子 麝香 天南星 附子 朱砂 牛黄 蜈蚣	慢惊 急惊 痫 神昏 四肢抽搐 面色青 脱肛 恶寒发热 唇肿 妊娠咳嗽
麦冬 知母 甘草 玄参 黄柏 沙参 黄芩 石膏 天冬 黄连	口渴 咽干 鼻干 心烦 消瘦 烦躁 舌干 口臭 不寐 头昏
防风 菊花 藜 羌活 蒺藜 荆芥 苦参 羚羊角 细辛 独活	目昏 皮肤瘙痒 流泪 远视 拳毛倒睫 头痛 胬肉攀睛 鼻塞 近视 舌强
木通 滑石 泽泻 车前 车前子 猪苓 大黄 瞿麦 茯苓 冬葵	小便不通 小便不利 尿血 难产 阴疮 大便溏 妊娠小便不通 咽肿 胞衣不下 舌苔黄
当归 桃 桃仁 红花 川芎 赤芍 肉桂 丹参 泽兰 延胡索	腹痛 难产 恶露不下 胸痛 胁痛 胞衣不下 胸闷 少腹痛 闭经 阴痒
厚朴 藿香 陈皮 砂仁 苍术 丁香 木香 香附 木瓜 沉香	呕吐 反胃 腹痛 噎膈 转筋 恶心 上吐下泻 腹泻 胸闷 产后腹痛
牛膝 杜仲 续断 川乌 五加 五加皮 草乌 木瓜 没药 独活	腰痛 瘫痪 骨痛 半身不遂 四肢麻木 关节疼痛 腰膝无力 产后腰痛 足痛 头摇
桑 茯苓 枳壳 甘草 大腹皮 槟榔 桑寄生 桑白皮 木香 桑叶	浮肿 气喘 小便不利 小儿口疮 少腹痛 胎动不安 头胀 寒战 漏睛 舌强
远志 党参 丹参 枸杞子 菟丝子 黄芪 酸枣仁 山药 五味子 柏子仁	头晕 心悸 健忘 多梦 胸闷 疲乏 食欲不振 须发早白 脱发 头昏
干姜 附子 吴茱萸 硫黄 肉桂 细辛 厚朴 高良姜 乌头 阳起石	腹痛 腹冷 手足厥冷 转筋 面色青 头重 舌干 上吐下泻 远视 心烦
甘草 人参 麦门冬 茯苓 犀角 升麻 羚羊角 地骨皮 枳壳 石膏	烦躁 心烦 壮热 牙痛 口臭 痫 吐血 带状疱疹 头重 呵欠
麝香 朱砂 雄黄 牛黄 巴豆 青黛 钩藤 犀角 龙齿 赭石	痫 神昏 慢惊 急惊 蟹睛 言语错乱 足颤 鼻痒 腰痛 尿血
香附 茴香 当归 木香 巴豆 乌药 沉香 白芍 附子 甘遂	白带 赤白带 咳血 弄舌 带状疱疹 闭经 浮肿 偏头痛 畏寒 小儿口疮
牵牛 槟榔 牛膝 木香 肉苁蓉 郁李 郁李仁 山茱萸 石斛 防己	耳聋 腰痛 浮肿 腰重 小便频数 腰脊痛 腰膝无力 阴痒 头昏 短气
