甘草 赤芍 当归 芍药 川芎 防风 黄芩 木通 荆芥 滑石	小便不通 难产 麻疹 小便不利 丹毒 头痛 吐血 尿血 腹痛 鼻塞
甘草 当归 芍药 人参 白芍 川芎 茯苓 防风 白术 羌活	自汗 头痛 短气 恶风 鼻塞 盗汗 腹痛 咳嗽 项强 恶寒
牡丹 牡丹皮 芍药 当归 赤芍 茯苓 甘草 柴胡 人参 附子	烦躁 潮热 盗汗 四肢疼痛 心烦 赤白带 五心烦热 吐血 消瘦 恶心
黄连 地榆 当归 黄芩 甘草 阿胶 蒲黄 赤石脂 黄柏 龙骨	吐血 腹痛 便血 脱肛 鼻衄 大便下血 里急后重 崩漏 心烦 尿血
泽泻 甘草 茯苓 黄连 车前 猪苓 车前子 陈皮 黄芩 木通	小便不利 腹痛 里急后重 发黄 小便不通 烦躁 呕吐 口渴 浮肿 积滞
升麻 白芷 甘草 苍术 当归 川芎 陈皮 柴胡 厚朴 防风	恶寒 头痛 身痛 口臭 脱肛 身重 恶寒发热 腹痛 恶风 项强
桂枝 甘草 当归 麻黄 乳香 川芎 防风 木香 白芍 没药	恶寒 四肢麻木 无汗 嘈杂 关节疼痛 恶寒发热 舌苔白 项强 嗳气 呃逆
巴豆 木香 五灵脂 芫花 甘遂 牵牛 三棱 乳香 丁香 大黄	腹痛 积滞 浮肿 恶心 小便不通 腹满 呕吐 痫 瘰疬 肠鸣
麦冬 当归 茯苓 杜仲 人参 白芍 牛膝 山药 甘草 白术	腰痛 口渴 盗汗 咳嗽 自汗 心烦 白带 头晕 胎动不安 咽干
杏仁 杏 甘草 紫菀 五味子 款冬花 半夏 人参 阿胶 桑	咳嗽 气喘 短气 咽干 吐血 鼻塞 呕吐 心烦 胸闷 多唾
半夏 甘草 生姜 茯苓 人参 厚朴 枳实 前胡 白术 桔梗	呕吐 咳嗽 腹满 心下痞 头痛 腹痛 干呕 吞酸 恶寒 烦躁
甘草 石膏 大黄 薄荷 连翘 黄芩 桔梗 栀子 钩藤 滑石	痫 壮热 头痛 心烦 咳嗽 口渴 烦躁 大便秘结 恶风 神昏
阿胶 当归 川芎 白芍 甘草 白术 香附 艾叶 茯苓 砂仁	腹痛 胎动不安 赤白带 白带 吐血 胎漏 崩漏 漏下 不孕 便血
甘草 人参 柴胡 桔梗 桑 茯苓 知母 地骨皮 当归 鳖甲	咳嗽 潮热 盗汗 壮热 寒热往来 心烦 口苦 五心烦热 消瘦 胁痛
炙甘草 枇杷 枇杷叶 甘草 沙参 陈皮 白术 半夏 茯苓 麦冬	咳嗽 咽干 干呕 呕吐 吐血 口渴 舌干 头晕 胃痛 口臭
三棱 青皮 莪术 槟榔 神曲 木香 陈皮 黄连 使君子 山楂	疳积 腹痛 消瘦 潮热 积滞 口臭 嘈杂 恶心 食欲不振 呕吐
大黄 甘草 牵牛 茯苓 当归 芍药 黄芩 牵牛子 人参 赤芍	杨梅疮 鼻衄 腹痛 瘰疬 大便秘结 咳嗽 小便不利 丹毒 目昏 小便不通
甘草 杏 杏仁 茯苓 人参 麻黄 石膏 芍药 防风 黄芩	头痛 壮热 口噤 咳嗽 恶寒 恶风 无汗 呕吐 角弓反张 舌强
附子 白附子 麝香 天麻 僵蚕 朱砂 天南星 全蝎 防风 牛黄	慢惊 痫 头痛 急惊 神昏 角弓反张 半身不遂 目昏 口噤 咳嗽
甘草 黄芩 升麻 栀子 芍药 柴胡 石膏 麦门冬 大黄 赤芍	壮热 头痛 烦躁 心烦 谵语 发黄 发狂 舌干 口渴 咽干
远志 茯苓 甘草 人参 山药 石菖蒲 白术 酸枣仁 当归 黄连	健忘 烦躁 痫 心悸 不寐 心烦 盗汗 多梦 自汗 口渴
巴豆 杏 杏仁 大黄 附子 雄黄 藜芦 木香 藜 麝香	痫 腹满 瘰疬 口噤 咳嗽 壮热 恶心 腹痛 吐血 难产
菟丝子 鹿茸 肉苁蓉 牛膝 杜仲 五味子 附子 茯苓 远志 人参	腰痛 耳聋 健忘 小便频数 白带 少气 头昏 头晕 短气 不孕
白芍 芥子 柴胡 白芥 白芥子 甘草 当归 香附 茯苓 白术	恶心 胁痛 腹满 腹痛 咳嗽 吞酸 嘈杂 嗳气 胃痛 面色青
甘草 当归 柴胡 白芍 人参 白术 陈皮 黄芩 川芎 茯苓	头痛 寒热往来 口苦 胁痛 腹痛 咳嗽 呕吐 自汗 舌干 但热不寒
藿香 甘草 半夏 陈皮 木香 白芷 厚朴 茯苓 紫苏叶 香薷	呕吐 头痛 腹痛 转筋 恶心 恶寒 胸闷 上吐下泻 鼻塞 腹泻
生姜 葱白 桑 防风 甘草 羌活 当归 桑枝 桃 白芷	恶寒 头痛 骨痛 身痛 腹痛 干呕 鼻干 咳嗽 转筋 无汗
瓜蒌 木香 甘草 沉香 半夏 枳实 红花 大黄 杏仁 杏	大便秘结 鼻衄 咳嗽 呕吐 呃逆 吐血 腹痛 舌苔白 嘈杂 咳血
麝香 朱砂 黄连 巴豆 轻粉 雄黄 熊胆 牛黄 胡黄连 青黛	壮热 痫 急惊 慢惊 目昏 流泪 疳积 臁疮 腹痛 心烦
竹叶 甘草 淡竹 淡竹叶 苍耳 常山 苍耳子 白芷 薄荷 防风	烦躁 鼻塞 壮热 头痛 口渴 咽干 发狂 鼻衄 小便不利 寒战
乳香 没药 当归 白芷 杏 蓖麻 杏仁 白及 蓖麻子 冬瓜	瘰疬 臁疮 无名肿毒 浮肿 耳聋 吐血 阴疮 湿疮 牙痛 瘫痪
丹参 当归 黄芪 女贞 女贞子 何首乌 川芎 牛膝 桑 麦冬	头晕 心悸 心烦 胸闷 头昏 健忘 多梦 须发早白 脱发 头痛
豆蔻 木香 附子 茯苓 人参 甘草 诃子 白术 白豆蔻 羌活	肠鸣 恶心 呕吐 转筋 腹痛 瘫痪 口噤 口苦 面色青 吞酸
乌头 干姜 细辛 防风 人参 附子 白术 茯苓 甘草 川乌	耳聋 恶风 少气 头痛 短气 口噤 头重 鼻塞 浮肿 背痛
甘草 牡蛎 麻黄 车前 麻黄根 金银花 车前子 连翘 当归 黄芩	盗汗 口苦 自汗 头痛 恶寒 舌苔黄 咳嗽 发黄 胸闷 口渴
槟榔 郁李 郁李仁 木香 枳壳 大黄 茯苓 芍药 大腹皮 鳖甲	浮肿 小便不利 腹痛 腹满 气喘 腰重 小便不通 咽干 里急后重 口苦
豆蔻 丁香 白术 木香 人参 厚朴 生姜 甘草 干姜 肉豆蔻	呕吐 腹痛 肠鸣 恶心 呃逆 转筋 吞酸 腹冷 反胃 咳嗽
龙骨 牡蛎 当归 附子 桑 赤石脂 鹿茸 干姜 人参 禹余粮	白带 崩中 赤白带 小便频数 盗汗 漏下 遗尿 腰痛 脱肛 腹冷
乳香 没药 麝香 血竭 丁香 雄黄 当归 冰片 轻粉 肉桂	臁疮 无名肿毒 瘰疬 杨梅疮 腹痛 口臭 鼻衄 腰痛 骨痛 白带
藜 蒺藜 鹿角 鹿角胶 防风 苦参 人参 附子 当归 玄参	口噤 皮肤瘙痒 目昏 角弓反张 短气 舌强 吐血 四肢拘急 恶风 头痛
人参 当归 甘草 白术 附子 干姜 肉桂 木香 茯苓 吴茱萸	腹痛 呕吐 手足厥冷 短气 自汗 腹冷 畏寒 面色青 气喘 寒战
甘草 麝香 牛黄 朱砂 琥珀 硼砂 薄荷 冰片 雄黄 天竺黄	慢惊 痫 咳嗽 烦躁 急惊 口噤 舌肿 角弓反张 神昏 气喘
甘草 人参 干姜 大枣 生姜 茯苓 麦门冬 白术 乌梅 附子	短气 腹痛 少气 呕吐 咳嗽 小便不利 恶寒 腹满 自汗 心烦
益智 甘草 益智仁 陈皮 罂粟 木香 罂粟壳 砂仁 干姜 丁香	恶心 呕吐 腹痛 肠鸣 吞酸 遗尿 咳嗽 里急后重 口苦 小便频数
白矾 薄荷 甘草 半夏 杏 天南星 杏仁 丁香 桔梗 陈皮	咳嗽 恶心 呕吐 头痛 痫 目昏 粉刺 鼻塞 头晕 烦躁
牛黄 甘草 黄连 朱砂 冰片 黄芩 大黄 郁金 麝香 天麻	烦躁 痫 神昏 谵语 咳嗽 急惊 壮热 头痛 耳聋 发狂
桃 桃仁 当归 大黄 甘草 芍药 木香 赤芍 升麻 连翘	腹痛 瘰疬 壮热 舌干 恶露不下 吐血 心烦 大便秘结 胸痛 四肢疼痛
知母 黄连 黄柏 甘草 当归 人参 柴胡 麦门冬 天门冬 龙胆	烦躁 潮热 盗汗 心烦 咳嗽 吐血 五心烦热 耳聋 口苦 目昏
川乌 乌头 草乌 牛膝 地龙 附子 乳香 没药 当归 白芷	瘫痪 头痛 半身不遂 目昏 腰痛 头昏 骨痛 心烦 牙痛 神昏
秦艽 桔梗 防风 甘草 羌活 荆芥 紫草 连翘 天麻 枳壳	壮热 谵语 烦躁 瘰疬 麻疹 半身不遂 头汗 气喘 潮热 无名肿毒
当归 大黄 苦参 白芷 昆布 甘草 防风 乳香 夏枯草 海藻	瘰疬 腹满 无名肿毒 麻疹 杨梅疮 消瘦 舌干 恶露不下 瘫痪 积滞
桑 桑白皮 杏 杏仁 甘草 桔梗 款冬花 紫菀 知母 麻黄	咳嗽 气喘 浮肿 咳痰 口渴 咽干 麻疹 头痛 面色白 痄腮
甘草 桑 郁金 薄荷 桑叶 杏 连翘 杏仁 当归 菊花	咳嗽 流泪 咽干 目昏 口渴 头痛 舌干 心烦 烦躁 头晕
党参 甘草 白术 当归 茯苓 山药 牡蛎 龙骨 黄芪 白芍	白带 自汗 赤白带 食欲不振 腹泻 盗汗 漏下 崩漏 消瘦 大便溏
五加 地骨皮 五加皮 菊花 甘草 茯苓 车前 车前子 防风 当归	目昏 浮肿 腰痛 四肢疼痛 头晕 腰脊痛 远视 小便不利 项强 四肢拘急
甘草 杏仁 杏 茯苓 枳壳 前胡 桔梗 羌活 桑 麻黄	咳嗽 头痛 无汗 恶寒 浮肿 鼻塞 气喘 小便不利 身痛 壮热
甘草 防风 牛蒡 荆芥 连翘 牛蒡子 川芎 黄芩 桔梗 薄荷	头痛 鼻塞 麻疹 壮热 恶寒 牙痛 口渴 舌干 丹毒 咳嗽
桃 桃仁 茴香 当归 川芎 香附 小茴香 红花 木香 甘草	腹痛 腰痛 白带 腹冷 胁痛 赤白带 不孕 骨痛 少腹痛 闭经
陈皮 甘草 半夏 茯苓 白术 厚朴 苍术 砂仁 神曲 香附	呕吐 恶心 腹痛 吞酸 嗳气 咳嗽 嘈杂 身重 头痛 噎膈
防风 甘草 麝香 犀角 羚羊角 朱砂 牛黄 菊花 枳壳 人参	目昏 头痛 痫 腹痛 手足厥冷 头昏 神昏 烦躁 发狂 项强
