甘草 茯苓 白术 当归 人参 陈皮 半夏 黄芩 芍药 附子	小便不利 浮肿 小便不通 发黄 舌苔白 心下痞 舌苔白腻 气喘 黄汗 善太息
甘草 当归 茯苓 人参 白术 陈皮 木香 半夏 白芍 黄连	盗汗 潮热 自汗 消瘦 小儿厌食 善食易饥 面色青 目羞明 经行先后无定期 小儿多汗
甘草 茯苓 当归 人参 白术 半夏 芍药 柴胡 附子 陈皮	痫 慢惊 急惊 神昏 弄舌 发癫 啮齿 喉中痰鸣 产后胁痛 口唇淡白
甘草 茯苓 当归 黄芩 人参 川芎 白术 半夏 防风 附子	目昏 头痛 流泪 壮热 牙痛 胬肉攀睛 拳毛倒睫 目干涩 漏睛 鼻痒
甘草 茯苓 当归 白术 人参 半夏 黄芩 陈皮 防风 柴胡	咳嗽 气喘 吐血 寒热往来 妊娠咳嗽 鼻痒 烦躁 唇肿 大便艰难 身重
甘草 茯苓 人参 当归 白术 陈皮 附子 芍药 半夏 柴胡	腹满 干呕 小便不通 短气 心下痞 发黄 寒战 足热 面色白 背痛
甘草 人参 当归 茯苓 白术 芍药 川芎 木香 干姜 桔梗	腹痛 胎动不安 腰痛 产后腹痛 少腹痛 胁痛 大便下血 晕厥 恶露不断 经行腹痛
甘草 茯苓 人参 当归 半夏 白芍 川芎 木香 防风 芍药	呕吐 恶心 头昏 干呕 小儿呕吐 腹痛 鼻塞 吐血 恶露不断 皮肤甲错
甘草 当归 茯苓 人参 黄芩 白术 半夏 陈皮 木香 川芎	胁痛 耳聋 盗汗 寒热往来 心烦 口苦 自汗 多唾 头晕 瘰疬
甘草 当归 茯苓 人参 大黄 白术 黄芩 黄连 川芎 芍药	吐血 鼻衄 便血 咳血 尿血 月经过多 汗血 崩漏 血精 小便浑浊
甘草 当归 茯苓 人参 柴胡 白术 白芍 川芎 黄芩 半夏	心烦 五心烦热 盗汗 潮热 咽干 寒热往来 消瘦 妊娠心烦 善怒 舌紫
甘草 茯苓 当归 人参 川芎 白术 附子 芍药 木香 半夏	目昏 痫 烦躁 神昏 慢惊 健忘 皮肤瘙痒 远视 舌强 四肢疼痛
甘草 当归 茯苓 人参 半夏 白术 附子 陈皮 防风 桔梗	腹痛 呕吐 恶心 肠鸣 积滞 咳嗽 小便不通 吞酸 目痒 牙痛
甘草 当归 茯苓 黄芩 人参 川芎 防风 木香 白术 麝香	瘰疬 无名肿毒 臁疮 杨梅疮 牙痛 湿疮 耳痛 天疱疮 耳内流脓 痄腮
甘草 当归 茯苓 陈皮 人参 黄芩 白术 半夏 防风 川芎	咳嗽 腹痛 呕吐 口臭 大便秘结 腹泻 舌干 头热 小儿腹泻 呃逆
甘草 当归 茯苓 人参 川芎 黄芩 陈皮 桔梗 芍药 白芍	咳嗽 麻疹 大便秘结 头痛 呵欠 喷嚏 牙龈肿痛 牙痛 咽喉痛 声音嘶哑
甘草 茯苓 当归 人参 白术 木香 附子 干姜 芍药 陈皮	白带 赤白带 崩漏 月经过多 发狂 过期不产 背热 小儿口疮 少腹痛 乳头破裂
甘草 茯苓 当归 人参 白术 枳壳 黄芩 黄连 陈皮 半夏	吞酸 嘈杂 嗳气 呃逆 呕吐 恶心 食欲不振 胃痛 舌苔白 四肢抽搐
甘草 茯苓 黄芩 当归 柴胡 人参 石膏 大黄 黄连 白术	口渴 咽干 烦躁 心烦 鼻干 舌苔黄 口臭 头汗 咽肿 舌苔黄腻
甘草 茯苓 当归 人参 白术 半夏 陈皮 黄连 枳壳 大黄	腹痛 积滞 疳积 反胃 噎膈 呕吐 大便溏 胃痛 小儿腹痛 妊娠呕吐
甘草 当归 人参 白术 茯苓 黄芩 防风 川芎 芍药 附子	口噤 角弓反张 项强 痫 四肢拘急 舌强 急惊 头热 头摇 四肢强直
甘草 茯苓 当归 人参 白术 川芎 附子 木香 干姜 芍药	腰痛 小便频数 目昏 盗汗 消瘦 腰重 不孕 腹冷 头昏 耳聋
甘草 茯苓 当归 白术 人参 芍药 柴胡 黄芩 防风 半夏	恶风 自汗 项强 短气 头重 身重 四肢拘急 鼻干 小便黄赤 腰脊痛
甘草 茯苓 当归 人参 白术 陈皮 黄芩 川芎 木香 桔梗	咳嗽 潮热 慢惊 烦躁 痫 急惊 气喘 自汗 小儿水痘 白带
甘草 当归 黄芩 黄连 茯苓 川芎 大黄 防风 人参 黄柏	瘰疬 丹毒 牙痛 麻疹 无名肿毒 胎毒 皮肤瘙痒 痄腮 舌肿 粉刺
甘草 茯苓 白术 人参 当归 陈皮 大黄 黄芩 半夏 木香	咳嗽 头痛 烦躁 鼻塞 壮热 口渴 四肢抽搐 大便秘结 胁痛 肠鸣
甘草 当归 茯苓 防风 人参 白术 川芎 芍药 黄芩 羌活	半身不遂 瘫痪 四肢疼痛 耳聋 腰痛 头昏 臂痛 言语错乱 骨痛 足痛
甘草 茯苓 当归 人参 陈皮 白术 桔梗 川芎 半夏 厚朴	恶寒 无汗 恶寒发热 头痛 身痛 乳汁不行 胸闷 舌苔白 头重 肩痛
甘草 当归 茯苓 白术 人参 黄芩 陈皮 附子 木香 防风	腹痛 肠鸣 里急后重 脱肛 手足厥冷 大便脓血 大便失禁 小儿啼哭 牙齿浮动 气从少腹上冲
甘草 当归 人参 茯苓 附子 白术 陈皮 半夏 川芎 白芍	壮热 头痛 咳嗽 鼻塞 舌青 不射精 口渴 粉刺 痄腮 身热肢寒
甘草 茯苓 人参 当归 半夏 陈皮 黄芩 白术 木香 附子	咳嗽 气喘 胸闷 咳痰 喉痒 胸痛 背冷 小儿发热 哮鸣 顿咳
甘草 当归 人参 茯苓 半夏 黄芩 白术 川芎 木香 麝香	呕吐 恶心 吞酸 反胃 面色红 寒战 舌麻 小儿五软 皮肤皲裂 小儿呕吐
甘草 人参 茯苓 当归 半夏 防风 黄芩 白术 芍药 陈皮	咳嗽 头痛 壮热 鼻塞 咽喉痛 舌疮 四肢疼痛 潮热 小儿发热 尿脓
甘草 人参 黄芩 茯苓 当归 白术 半夏 芍药 白芍 川芎	口苦 舌干 咽干 寒热往来 小便黄赤 心烦 但热不寒 足颤 云雾移睛 口酸
甘草 人参 当归 茯苓 白术 陈皮 黄芩 防风 麻黄 半夏	头痛 鼻塞 恶寒 无汗 恶风 身痛 身重 恶寒发热 四肢抽搐 产后身痛
甘草 当归 茯苓 人参 川芎 白术 附子 防风 木香 苍术	半身不遂 四肢麻木 腰痛 骨痛 瘫痪 关节疼痛 腰膝无力 背痛 皮肤瘙痒 膝肿痛
甘草 当归 茯苓 人参 白术 川芎 黄芩 陈皮 半夏 木香	头晕 胸闷 心悸 健忘 头昏 心烦 多梦 不寐 胸痛 肥胖
甘草 当归 茯苓 人参 白芍 白术 牛膝 桑 五味子 熟地黄	头晕 健忘 心悸 食欲不振 疲乏 多梦 畏寒 须发早白 脱发 自汗
甘草 人参 茯苓 当归 防风 白术 川芎 枳壳 柴胡 白芍	烦躁 咳嗽 口渴 潮热 大便下血 心烦 壮热 谵语 善疑 咽干
甘草 茯苓 人参 当归 附子 白术 半夏 芍药 防风 干姜	短气 少气 小便不利 浮肿 背痛 腹满 腰脊痛 多唾 胸痛 恶风
甘草 当归 茯苓 川芎 人参 木香 白术 芍药 陈皮 半夏	浮肿 腹痛 难产 胞衣不下 恶露不下 尿血 经行腹痛 产后血崩 产后浮肿 噎膈
甘草 人参 茯苓 当归 黄芩 白术 川芎 黄连 桔梗 半夏	神昏 烦躁 谵语 发狂 痫 不寐 四肢抽搐 独语 口中生疮 口流涎
甘草 当归 人参 茯苓 附子 白术 黄芩 柴胡 川芎 陈皮	头痛 壮热 鼻塞 偏头痛 恶风 鼻痛 妊娠头痛 目昏 头皮麻木 体臭
甘草 茯苓 白术 人参 当归 附子 木香 半夏 干姜 陈皮	腹痛 转筋 手足厥冷 腹冷 面色青 身重 上吐下泻 大便溏 畏寒 口淡
甘草 当归 人参 白术 茯苓 白芍 川芎 芍药 附子 陈皮	崩漏 漏下 崩中 不孕 遗尿 脱肛 胎漏 少气 闭经 腹冷
