乳香 没药 川乌 乌头 草乌 白芷 轻粉 五灵脂 血竭 麝香	瘰疬 臁疮 无名肿毒 牙痛 瘫痪 半身不遂 杨梅疮 湿疮 骨痛 腹中痞块
薄荷 连翘 桔梗 荆芥 牛蒡 牛蒡子 防风 金银花 荷叶 玄参	麻疹 头痛 鼻塞 口渴 恶寒 牙痛 杨梅疮 丹毒 谵语 痄腮
大黄 巴豆 白矾 硫黄 郁金 皂荚 青黛 甘草 雄黄 寒水石	瘰疬 丹毒 口臭 胎毒 阴疮 舌肿 湿疮 粉刺 壮热 小儿口疮
陈皮 神曲 香附 砂仁 厚朴 苍术 山楂 麦芽 青皮 枳实	呕吐 吞酸 恶心 嘈杂 嗳气 胃痛 呃逆 食欲不振 反胃 腹泻
甘草 防风 菊花 石膏 藜 蒺藜 枳壳 细辛 前胡 荆芥	目昏 头痛 流泪 皮肤瘙痒 拳毛倒睫 胬肉攀睛 远视 鼻衄 瞳神散大 面色青
防风 独活 麻黄 羌活 细辛 附子 羚羊角 秦艽 五加 当归	口噤 半身不遂 项强 恶风 四肢拘急 角弓反张 舌强 瘫痪 头重 呵欠
黄芪 何首乌 女贞 女贞子 党参 枸杞子 黄精 山药 淫羊藿 五味子	头晕 心悸 健忘 胸闷 食欲不振 多梦 头昏 疲乏 须发早白 脱发
柴胡 甘草 人参 知母 地骨皮 鳖甲 麦门冬 秦艽 茯苓 青蒿	潮热 盗汗 心烦 寒热往来 五心烦热 咽干 消瘦 但热不寒 壮热 口苦
甘草 生姜 麻黄 人参 大枣 半夏 桂枝 葛根 芍药 葱白	恶寒 无汗 恶风 恶寒发热 头痛 身痛 项强 心烦 寒战 盗汗
甘草 麦冬 桔梗 芦根 紫苏叶 枇杷叶 枳壳 黄芩 枇杷 百部	咳嗽 胸闷 腹泻 舌苔白 呃逆 吐血 肥胖 舌苔白腻 小儿发热 身痛
干姜 附子 吴茱萸 白术 肉桂 厚朴 人参 生姜 细辛 当归	腹痛 腹冷 手足厥冷 转筋 面色青 肠鸣 干呕 背痛 寒战 善怒
人参 远志 茯苓 麦门冬 五味子 生地黄 牡丹 牡丹皮 石菖蒲 天门冬	自汗 少气 心烦 盗汗 健忘 吐血 不寐 五心烦热 耳聋 近视
木香 槟榔 青皮 三棱 莪术 牵牛 大黄 枳壳 茴香 牵牛子	腹满 积滞 腹痛 反胃 噎膈 浮肿 大便秘结 胁痛 寒热往来 呕吐
威灵仙 木瓜 红花 桂枝 当归 白芷 独活 牛膝 川乌 樟脑	耳聋 骨痛 腰痛 四肢麻木 背痛 吐血 胁痛 关节疼痛 畏寒 臂痛
牛膝 杜仲 山药 菟丝子 五味子 山茱萸 石斛 肉苁蓉 续断 鹿茸	腰痛 耳聋 小便频数 遗尿 盗汗 不孕 腰重 腰膝无力 头昏 畏寒
木香 丁香 豆蔻 沉香 肉豆蔻 砂仁 益智 白豆蔻 草豆蔻 藿香	呕吐 恶心 腹痛 肠鸣 吞酸 小儿呕吐 口淡 舌卷 小儿啼哭 转筋
桑 茯苓 枳壳 槟榔 甘草 防己 大腹皮 郁李 郁李仁 桑白皮	浮肿 气喘 小便不利 阴痒 产后浮肿 身痛 壮热 头昏 妊娠心腹胀满 呕吐
升麻 甘草 犀角 石膏 麦门冬 黄芩 葛根 知母 玄参 栀子	壮热 烦躁 头痛 舌干 鼻干 咽喉痛 口中生疮 头重 胃痛 牙痛
当归 白芍 川芎 芍药 白术 香附 熟地黄 生地黄 阿胶 益母草	腹痛 胎动不安 不孕 崩漏 胎漏 自汗 产后腹痛 滑胎 小儿腹痛 足颤
半夏 陈皮 厚朴 白术 茯苓 生姜 甘草 人参 藿香 木瓜	呕吐 恶心 转筋 上吐下泻 小儿呕吐 干呕 心下痞 白带 头昏 腹泻
人参 甘草 白术 茯苓 半夏 干姜 当归 芍药 肉桂 沉香	短气 自汗 身重 心下痞 腹满 头重 恶心 心下悸 干呕 胁痛
川芎 白芷 防风 羌活 细辛 苍术 荆芥 藁本 薄荷 蔓荆子	头痛 鼻塞 头昏 偏头痛 无汗 腹痛 面痛 头重 神昏 发黄
甘草 白术 人参 茯苓 陈皮 白芍 炙甘草 当归 党参 生地黄	口苦 心烦 舌干 咽干 消瘦 胁痛 潮热 口淡 大便溏 畏寒
附子 天麻 僵蚕 白附子 全蝎 天南星 麝香 朱砂 蜈蚣 赭石	慢惊 痫 急惊 神昏 口噤 角弓反张 壮热 四肢抽搐 瘫痪 恶心
麝香 朱砂 牛黄 雄黄 冰片 琥珀 天竺黄 钩藤 珍珠 犀角	痫 神昏 慢惊 急惊 壮热 发狂 弄舌 牙痛 胎毒 胬肉攀睛
黄连 甘草 乌梅 黄柏 木香 胡黄连 芦荟 使君子 青黛 芜荑	里急后重 脱肛 疳积 腹痛 便血 消瘦 口臭 大便下血 烦躁 潮热
当归 阿胶 白芍 龙骨 牡蛎 赤石脂 艾叶 党参 香附 地榆	白带 赤白带 崩漏 崩中 漏下 胎漏 吐血 转筋 产后血崩 耳痒
杏 杏仁 紫菀 麻黄 桑 款冬花 五味子 桑白皮 桔梗 百部	咳嗽 气喘 妊娠咳嗽 喉痒 咳血 舌苔白 畏寒 身重 脱发 尿痛
黄芩 大黄 栀子 黄连 黄柏 柴胡 枳实 茵陈 龙胆 甘草	烦躁 谵语 发黄 大便秘结 发狂 腹满 舌苔黄 小便黄赤 头汗 舌苔黄腻
甘草 麦冬 知母 竹叶 竹茹 玄参 黄芩 枇杷 沙参 枇杷叶	口渴 咽干 烦躁 心烦 干呕 咳嗽 谵语 不寐 发狂 面色白
芍药 赤芍 甘草 黄芩 柴胡 当归 石膏 升麻 葛根 生地黄	壮热 头痛 四肢疼痛 项强 身重 谵语 天疱疮 不射精 黄汗 恶心
泽泻 茯苓 木通 滑石 车前 车前子 猪苓 甘草 瞿麦 山药	小便不利 小便不通 尿血 难产 小便黄赤 多唾 妊娠小便不通 咽肿 小儿发热 蟹睛
半夏 桔梗 枳壳 前胡 甘草 陈皮 茯苓 橘红 瓜蒌 芥子	咳嗽 胁痛 多唾 鼻塞 咳痰 气喘 乳汁不行 神昏 嗳气 远视
雄黄 麝香 黄连 丁香 芍药 附子 升麻 大黄 槟榔 牛黄	吐血 鼻衄 便血 咳血 胁痛 呵欠 带状疱疹 反胃 口噤 不寐
当归 桃 桃仁 红花 川芎 香附 丹参 蒲黄 延胡索 肉桂	腹痛 难产 胞衣不下 恶露不下 胸痛 心烦 胁痛 产后腹痛 少腹痛 闭经
