泽泻 藜 甘草 蒺藜 茯苓 猪苓 车前 木通 滑石 车前子	小便不通 小便不利 里急后重 腹痛 浮肿 难产 尿血 烦躁 脱肛 腹泻
黄连 龙胆 胡黄连 柴胡 甘草 麝香 芦荟 大黄 茵陈 青黛	壮热 烦躁 发黄 潮热 心烦 口苦 盗汗 胁痛 咳嗽 瘰疬
益智 益智仁 茯苓 白术 木香 当归 沉香 人参 石斛 五味子	腹痛 赤白带 遗尿 白带 浮肿 小便频数 腹满 难产 肠鸣 盗汗
牛膝 当归 川乌 草乌 没药 乳香 防风 独活 地龙 威灵仙	瘫痪 腰痛 半身不遂 骨痛 浮肿 臂痛 四肢麻木 口苦 四肢疼痛 偏头痛
鹿角 人参 茯苓 当归 远志 鹿角胶 酸枣仁 柏子仁 山药 五味子	健忘 目昏 盗汗 吐血 耳聋 不寐 头晕 心烦 痫 烦躁
天门冬 茯苓 甘草 麦门冬 地骨皮 人参 车前 车前子 远志 生地黄	盗汗 咳嗽 吐血 心烦 潮热 耳聋 舌干 短气 白带 咽干
甘草 竹叶 黄芩 连翘 淡竹 栀子 黄连 淡竹叶 石膏 薄荷	烦躁 口渴 头痛 咳嗽 麻疹 谵语 心烦 壮热 咽干 发狂
杏仁 杏 甘草 紫菀 桑 款冬花 五味子 桔梗 人参 茯苓	咳嗽 气喘 短气 浮肿 呕吐 咽干 咳血 鼻塞 心烦 妊娠咳嗽
甘草 知母 麦门冬 人参 竹茹 黄芩 茯苓 枇杷 枇杷叶 当归	烦躁 心烦 头痛 壮热 呕吐 干呕 咳嗽 吐血 舌干 潮热
甘草 犀角 大黄 黄芩 牛黄 石膏 升麻 人参 朱砂 龙齿	痫 烦躁 壮热 神昏 心烦 头痛 谵语 发狂 口渴 丹毒
防风 羌活 独活 甘草 麻黄 附子 细辛 川芎 当归 柴胡	头痛 口噤 项强 角弓反张 恶风 目昏 舌强 恶寒 鼻塞 四肢拘急
牛蒡 牛蒡子 甘草 天花粉 连翘 桔梗 玄参 防风 黄芩 荆芥	壮热 麻疹 谵语 口渴 丹毒 烦躁 咳嗽 舌干 腹痛 瘰疬
甘草 菊花 麦冬 白芍 桑 黄芩 玄参 当归 知母 女贞	头晕 流泪 目昏 烦躁 头痛 头昏 心悸 咽干 潮热 心烦
麝香 冰片 乳香 雄黄 朱砂 没药 牛黄 血竭 轻粉 珍珠	臁疮 无名肿毒 腹痛 转筋 头痛 杨梅疮 呕吐 痫 胸闷 瘰疬
川乌 乌头 白芷 细辛 附子 川芎 防风 甘草 藿香 甘松	头痛 鼻塞 牙痛 目昏 壮热 口噤 口臭 半身不遂 恶心 白带
杏 杏仁 大黄 当归 芍药 黄芩 麻黄 甘草 牡丹 桃	壮热 恶寒 恶风 少气 咳嗽 四肢疼痛 腹满 头痛 心烦 短气
槟榔 大黄 郁李 郁李仁 枳壳 甘草 木香 芍药 茯苓 升麻	浮肿 小便不利 目昏 腹满 气喘 小便不通 烦躁 腹痛 心烦 里急后重
当归 红花 川芎 桃 桃仁 香附 赤芍 延胡索 莪术 木香	腹痛 赤白带 难产 白带 恶心 口噤 烦躁 恶露不下 潮热 胁痛
生姜 甘草 人参 半夏 干姜 厚朴 茯苓 白术 附子 大枣	呕吐 腹痛 短气 少气 腹满 干呕 恶寒 咳嗽 头痛 背痛
人参 茯苓 当归 甘草 白术 干姜 肉桂 附子 芍药 牡丹	腹痛 呕吐 自汗 腹冷 手足厥冷 浮肿 盗汗 短气 小便不利 口噤
豆蔻 甘草 白术 厚朴 木香 陈皮 人参 半夏 丁香 藿香	呕吐 腹痛 恶心 肠鸣 吞酸 积滞 反胃 转筋 腹冷 嘈杂
朱砂 麝香 附子 半夏 天南星 白附子 僵蚕 天麻 牛黄 全蝎	痫 慢惊 急惊 咳嗽 神昏 头痛 呕吐 烦躁 角弓反张 口噤
甘草 桂枝 防风 麻黄 生姜 芍药 独活 当归 细辛 茯苓	恶寒 头痛 恶风 无汗 口噤 项强 恶寒发热 浮肿 腹痛 身痛
当归 红花 丹参 桃 蜈蚣 防风 全蝎 川芎 羌活 大黄	鼻衄 无名肿毒 瘰疬 半身不遂 四肢麻木 胸闷 难产 咽干 背痛 头痛
川芎 防风 甘草 荆芥 薄荷 细辛 天麻 当归 羌活 僵蚕	头痛 鼻塞 目昏 半身不遂 耳聋 头昏 牙痛 瘫痪 咳嗽 痫
芥子 白芥 白芥子 藿香 川芎 甘草 陈皮 薄荷 半夏 香附	胸闷 头痛 恶心 咳嗽 呕吐 腹痛 恶寒 腹满 肥胖 发狂
巴豆 杏 杏仁 麝香 朱砂 木香 雄黄 轻粉 大黄 升麻	瘰疬 痫 急惊 耳聋 腹痛 臁疮 壮热 小便不通 咳嗽 疳积
菟丝子 鹿茸 肉苁蓉 杜仲 茯苓 牛膝 龙骨 人参 五味子 牡蛎	腰痛 头晕 盗汗 耳聋 健忘 小便频数 遗尿 白带 自汗 短气
牵牛 大黄 槟榔 木香 巴豆 三棱 牵牛子 使君子 陈皮 甘遂	腹痛 疳积 积滞 浮肿 消瘦 呕吐 大便秘结 小便不通 腹满 潮热
附子 木香 茴香 硫黄 丁香 沉香 干姜 豆蔻 吴茱萸 肉豆蔻	腹痛 面色青 腰痛 肠鸣 手足厥冷 赤白带 白带 呕吐 恶心 转筋
阿胶 当归 甘草 地榆 黄芩 桑 蒲黄 白芍 桑白皮 芍药	吐血 便血 腹痛 鼻衄 大便下血 尿血 崩漏 咳嗽 胎动不安 漏下
五加 五加皮 牛膝 当归 杜仲 茯苓 黄柏 人参 大腹皮 木香	浮肿 腰痛 口苦 盗汗 消瘦 目昏 赤白带 白带 食欲不振 舌干
甘草 白芍 当归 川芎 陈皮 半夏 香附 茯苓 白术 柴胡	腹痛 呕吐 胁痛 恶心 头痛 寒热往来 嘈杂 口苦 吞酸 咳嗽
甘草 橘红 茯苓 泽泻 苍术 当归 白术 半夏 防风 升麻	杨梅疮 身重 发黄 小便不利 心下痞 恶寒 呕吐 恶风 小便黄赤 阴疮
桃 桃仁 甘草 鳖甲 大黄 当归 附子 柴胡 人参 乌梅	腹满 腹痛 壮热 潮热 咳嗽 口噤 消瘦 大便秘结 烦躁 盗汗
当归 茴香 杜仲 川芎 小茴香 甘草 何首乌 牛膝 香附 女贞	腰痛 头晕 心悸 白带 头昏 疲乏 脱发 四肢麻木 腹痛 须发早白
山楂 茯苓 麦芽 白术 神曲 半夏 甘草 陈皮 黄连 枳实	呕吐 吞酸 腹痛 食欲不振 恶心 腹泻 嘈杂 嗳气 积滞 恶寒
甘草 白术 人参 茯苓 当归 川芎 羌活 白芷 防风 牛膝	头痛 咳嗽 舌干 身痛 转筋 目昏 半身不遂 腹痛 寒热往来 四肢疼痛
甘草 茯苓 人参 半夏 前胡 桔梗 枳壳 黄芩 白术 芍药	咳嗽 呕吐 头痛 壮热 寒热往来 气喘 口苦 目昏 小便不利 烦躁
麻黄 天麻 甘草 全蝎 防风 人参 白术 僵蚕 羌活 茯苓	慢惊 盗汗 痫 自汗 神昏 头痛 浮肿 腹痛 潮热 恶寒
乳香 没药 当归 甘草 白芷 木香 防风 香附 沉香 陈皮	瘰疬 恶心 嘈杂 嗳气 舌苔白 无名肿毒 胃痛 呕吐 吞酸 呃逆
杏仁 杏 甘草 麻黄 桔梗 前胡 半夏 陈皮 苦杏仁 桑	咳嗽 气喘 恶寒 鼻塞 头痛 咽干 无汗 胸闷 口渴 恶寒发热
薄荷 甘草 桑 白芷 杏 青黛 杏仁 连翘 硼砂 菊花	咳嗽 头痛 鼻塞 咽干 丹毒 口渴 鼻衄 呃逆 噎膈 瘫痪
龙骨 赤石脂 当归 乳香 干姜 麝香 没药 黄连 朱砂 禹余粮	腹痛 白带 赤白带 崩中 脱肛 肠鸣 漏下 骨痛 里急后重 便血
芍药 甘草 赤芍 石膏 柴胡 防风 黄芩 枳壳 茯苓 升麻	壮热 头痛 心烦 潮热 烦躁 目昏 四肢疼痛 盗汗 咽干 无汗
甘草 白术 当归 白芍 人参 茯苓 炙甘草 陈皮 麦冬 党参	自汗 心悸 咳嗽 口渴 健忘 头晕 盗汗 心烦 腹痛 脱肛
木香 丁香 茴香 甘草 陈皮 沉香 附子 香附 莪术 砂仁	呕吐 恶心 腹痛 吞酸 呃逆 腹满 肠鸣 干呕 口苦 口臭
当归 桑 芍药 白芍 甘草 桑寄生 人参 白术 茯苓 续断	腹痛 胎动不安 腰痛 白带 赤白带 漏下 少气 崩中 咳嗽 胎漏
白及 白芷 沙参 当归 赤芍 大黄 麦冬 木鳖子 白蔹 甘草	咳嗽 吐血 瘰疬 臁疮 口渴 鼻衄 咽干 无名肿毒 头痛 谵语
甘草 防风 黄芩 当归 川芎 荆芥 生地黄 芍药 白芷 羌活	头痛 大便秘结 皮肤瘙痒 恶寒 无汗 吐血 麻疹 烦躁 鼻衄 牙痛
