甘草 黄芩 石膏 升麻 犀角 连翘 大黄 麦门冬 玄参 黄连	烦躁 壮热 头痛 谵语 丹毒 心烦 麻疹 舌干 瘰疬 口渴
黄连 甘草 茯苓 泽泻 枳实 半夏 黄芩 白术 陈皮 猪苓	呕吐 目昏 小便不利 烦躁 腹痛 里急后重 头痛 流泪 口渴 心下痞
麦冬 甘草 人参 茯苓 当归 远志 鳖甲 柴胡 白芍 酸枣仁	心烦 健忘 烦躁 盗汗 咳嗽 口苦 口渴 潮热 舌干 吐血
甘草 杏 杏仁 芍药 麻黄 生姜 茯苓 赤芍 人参 黄芩	咳嗽 头痛 浮肿 壮热 气喘 恶寒 小便不利 呕吐 短气 腹满
甘草 防风 当归 苦参 丹参 金银花 川芎 白芷 人参 牛黄	痫 瘰疬 杨梅疮 皮肤瘙痒 头痛 心烦 壮热 胸闷 鼻衄 烦躁
甘草 桔梗 薄荷 桑 连翘 黄芩 杏 杏仁 荆芥 栀子	咳嗽 头痛 口渴 恶寒 鼻塞 麻疹 大便秘结 咽干 烦躁 气喘
车前 车前子 甘草 牡丹 牡丹皮 茯苓 牡蛎 黄芩 大黄 栀子	小便不通 盗汗 发黄 小便不利 烦躁 心烦 壮热 遗尿 白带 自汗
附子 黄连 茴香 木香 芥子 胡黄连 芦荟 白芥 白芥子 肉苁蓉	腰痛 疳积 耳聋 腹痛 消瘦 盗汗 手足厥冷 壮热 目昏 小便频数
麝香 朱砂 僵蚕 雄黄 天麻 全蝎 冰片 附子 牛黄 乳香	慢惊 痫 急惊 咳嗽 臁疮 神昏 腹痛 呕吐 无名肿毒 头痛
白术 茯苓 甘草 山药 人参 当归 神曲 陈皮 白芍 肉桂	自汗 腹痛 食欲不振 腰痛 呕吐 头晕 心悸 盗汗 吞酸 腹泻
甘草 杏 杏仁 紫菀 款冬花 竹叶 桑 半夏 桔梗 五味子	咳嗽 气喘 吐血 咽干 短气 呕吐 心烦 口渴 干呕 自汗
甘草 陈皮 川芎 白芷 厚朴 苍术 桔梗 羌活 半夏 茯苓	头痛 恶寒 呕吐 腹痛 咳嗽 恶心 无汗 浮肿 身痛 转筋
当归 甘草 芍药 白芍 黄芩 柴胡 白术 川芎 人参 阿胶	腹痛 吐血 胎动不安 胁痛 便血 白带 寒热往来 崩漏 鼻衄 口苦
当归 芍药 干姜 牡丹 赤石脂 赤芍 龙骨 甘草 附子 川芎	腹痛 白带 崩中 赤白带 漏下 里急后重 脱肛 心烦 崩漏 吐血
桃 桃仁 当归 没药 乳香 川芎 甘草 白芷 麝香 杏	腹痛 白带 赤白带 浮肿 腰痛 瘰疬 瘫痪 半身不遂 难产 臁疮
甘草 人参 麦门冬 当归 茯苓 五味子 知母 地骨皮 白芍 桑	潮热 咳嗽 盗汗 头晕 心烦 短气 烦躁 心悸 少气 咽干
巴豆 大黄 雄黄 干姜 麝香 朱砂 当归 附子 木香 三棱	瘰疬 腹痛 痫 无名肿毒 小便不通 积滞 浮肿 咳嗽 恶心 腹满
甘草 防风 人参 茯苓 细辛 羌活 升麻 当归 川芎 麻黄	头痛 口噤 鼻塞 恶风 目昏 恶寒 壮热 项强 自汗 咳嗽
防风 附子 牛膝 当归 川乌 羌活 天麻 独活 五加 麻黄	腰痛 半身不遂 头痛 口噤 瘫痪 四肢麻木 目昏 角弓反张 骨痛 痫
甘草 木香 豆蔻 白术 人参 干姜 厚朴 茯苓 丁香 附子	呕吐 腹痛 恶心 肠鸣 吞酸 转筋 腹满 腹冷 呃逆 干呕
