连翘 薄荷 桔梗 荆芥 牛蒡 黄芩 甘草 玄参 天花粉 竹叶	口渴 麻疹 咽干 丹毒 烦躁 谵语 恶寒 神昏 杨梅疮 鼻塞
干姜 附子 白术 吴茱萸 人参 肉桂 厚朴 细辛 甘草 生姜	腹痛 腹冷 手足厥冷 短气 肠鸣 背痛 面色青 转筋 少气 足热
甘草 人参 生姜 麦门冬 茯苓 大枣 半夏 竹茹 芍药 生地黄	烦躁 短气 心烦 干呕 少气 腹满 吐血 呕吐 口苦 言语错乱
陈皮 厚朴 神曲 苍术 砂仁 香附 山楂 青皮 麦芽 藿香	呕吐 吞酸 嘈杂 恶心 嗳气 反胃 胃痛 噎膈 腹泻 食欲不振
槟榔 木香 大黄 巴豆 三棱 青皮 莪术 牵牛 枳壳 郁李	浮肿 腹满 腹痛 积滞 气喘 疳积 大便秘结 消瘦 寒热往来 丹毒
麦冬 茯苓 远志 人参 丹参 五味子 山药 石菖蒲 酸枣仁 当归	心悸 头晕 健忘 胸闷 咽干 心烦 口渴 多梦 不寐 食欲不振
杏 杏仁 桑 紫菀 麻黄 桑白皮 款冬花 五味子 桔梗 百合	咳嗽 气喘 咳痰 喉痒 妊娠咳嗽 腹泻 腰重 鼻干 哮鸣 带状疱疹
黄连 黄柏 黄芩 栀子 大黄 胡黄连 青黛 生地黄 龙胆 芦荟	吐血 便血 里急后重 脱肛 壮热 鼻衄 口臭 大便下血 消瘦 疳积
朱砂 麝香 牛黄 僵蚕 天麻 白附子 附子 全蝎 天南星 雄黄	痫 慢惊 急惊 神昏 口噤 角弓反张 弄舌 四肢抽搐 小儿发热 腹痛
黄芩 大黄 栀子 犀角 升麻 甘草 石膏 玄参 麦门冬 羚羊角	烦躁 壮热 痫 谵语 发狂 发黄 舌干 咽喉痛 头痛 唇肿
当归 桃 赤芍 芍药 桃仁 牡丹 红花 牡丹皮 大黄 生地黄	腹痛 吐血 胁痛 四肢疼痛 鼻衄 心烦 耳聋 腰痛 大便秘结 恶露不下
防风 川芎 白芷 羌活 细辛 荆芥 苍术 独活 麻黄 藁本	头痛 恶寒 鼻塞 无汗 身痛 恶寒发热 项强 恶风 头昏 喷嚏
木香 丁香 豆蔻 沉香 肉豆蔻 茴香 诃子 砂仁 益智 藿香	呕吐 腹痛 恶心 肠鸣 吞酸 呃逆 反胃 口臭 腹冷 里急后重
乳香 麝香 没药 雄黄 冰片 轻粉 朱砂 血竭 巴豆 硼砂	瘰疬 臁疮 无名肿毒 牙痛 杨梅疮 湿疮 胎毒 阴疮 粉刺 小儿口疮
当归 阿胶 龙骨 白芍 牡蛎 芍药 赤石脂 艾叶 干姜 地榆	白带 赤白带 吐血 崩中 崩漏 漏下 胎漏 胎动不安 尿血 咳血
杜仲 牛膝 五味子 菟丝子 山药 山茱萸 肉苁蓉 熟地黄 枸杞子 石斛	腰痛 头晕 耳聋 盗汗 小便频数 遗尿 头昏 健忘 腰重 不孕
甘草 防风 菊花 藜 枳壳 石膏 蒺藜 细辛 羚羊角 荆芥	目昏 头痛 皮肤瘙痒 流泪 偏头痛 胬肉攀睛 拳毛倒睫 头胀 目干涩 瞳神散大
甘草 石膏 芍药 黄芩 葛根 柴胡 赤芍 升麻 麻黄 知母	头痛 壮热 无汗 鼻干 恶风 四肢疼痛 项强 咽喉痛 畏寒 舌强
半夏 桔梗 甘草 枳壳 前胡 茯苓 橘红 陈皮 瓜蒌 枇杷	咳嗽 气喘 鼻塞 胸闷 多唾 寒热往来 妊娠呕吐 腰重 妊娠咳嗽 小儿木舌
防风 川乌 独活 麻黄 当归 牛膝 羌活 乌头 草乌 附子	口噤 半身不遂 瘫痪 骨痛 角弓反张 四肢麻木 四肢拘急 项强 腰痛 舌强
茯苓 木通 泽泻 滑石 车前 车前子 防己 猪苓 甘草 桑	小便不利 小便不通 浮肿 尿血 发黄 小便黄赤 难产 肥胖 痱子 妊娠小便不通
川芎 当归 白芍 香附 白术 熟地黄 肉桂 陈皮 益母草 乌药	腹痛 胎动不安 胁痛 难产 不孕 崩漏 寒热往来 产后腹痛 闭经 胞衣不下
甘草 白术 人参 茯苓 炙甘草 当归 白芍 芍药 陈皮 桂枝	自汗 盗汗 恶寒 恶风 身重 头重 短气 潮热 神昏 口淡
柴胡 甘草 人参 知母 地骨皮 鳖甲 麦门冬 茯苓 秦艽 枳壳	潮热 心烦 口苦 盗汗 舌干 五心烦热 咽干 寒热往来 但热不寒 小便黄赤
半夏 白术 茯苓 甘草 陈皮 生姜 人参 厚朴 枳实 藿香	呕吐 恶心 转筋 心下痞 头痛 小儿呕吐 身重 头重 心下悸 大便溏
