浮萍 荸荠 鬼针草 鹿茸 皂角刺 莲房 穿心莲 瓦松 石吊兰 了哥王	头痛 呕吐 腹痛 大便秘结 胁痛 流泪 反胃 咳嗽 口渴 胃痛
海金沙 雪莲花 蛤蚧 人中白 凤凰衣 蛇莓 紫苏梗 艾叶 零陵香 桑	目昏 心烦 神昏 浮肿 呕吐 腹冷 口噤 赤白带 耳聋 恶风
龙齿 北豆根 天竺黄 郁李 龙胆 儿茶 女贞 白附子 桔梗 天花粉	咽干 呕吐 壮热 烦躁 潮热 急惊 慢惊 头痛 脱肛 尿血
黄连 益智仁 杠板归 徐长卿 五加 金荞麦 救必应 丝瓜 千金子 北豆根	壮热 心烦 小便不通 自汗 牙痛 慢惊 面色青 瘰疬 便血 口苦
地胆草 青葙子 棕榈炭 大戟 代赭石 望月砂 知母 茵陈 芫花 赤小豆	壮热 腹痛 咳嗽 腰痛 谵语 四肢拘急 舌苔白 四肢麻木 麻疹 疳积
陈皮 朱砂根 葫芦茶 金钱草 仙鹤草 鸭跖草 绵马贯众 芦荟 地骨皮 绞股蓝	呕吐 自汗 无汗 鼻衄 壮热 烦躁 盗汗 瘰疬 脱肛 口臭
连钱草 蒲黄 一枝黄花 南五味子 石膏 大麦 大头陈 丁香 鸡冠花 石韦	痫 寒热往来 积滞 发黄 盗汗 四肢疼痛 目昏 嘈杂 腹满 恶寒
石斛 三棵针 广枣 绵马贯众 虫白蜡 两头尖 红丹 杏 血竭 黄狗肾	口渴 慢惊 自汗 气喘 里急后重 无名肿毒 干呕 转筋 恶心 嘈杂
败酱 甘草 茵陈 合欢皮 亚麻 牛膝 芜荑 土茯苓 橘红 灶心土	头痛 腹痛 壮热 鼻塞 恶寒 耳聋 身重 头昏 身痛 吐血
龙眼肉 金礞石 槲寄生 蜂房 苦杏仁 紫草 竹茹 川木通 虻虫 橄榄核	咳嗽 气喘 腹满 小便不通 口噤 牙痛 崩中 头痛 舌干 健忘
槟榔 冬瓜子 自然铜 松塔 花生 地锦草 淡豆豉 木鳖子 功劳木 三叉苦	小便不利 潮热 痫 浮肿 口臭 麻疹 壮热 口渴 臁疮 发黄
佩兰 白英 羚羊角 荷叶 贯众 橘叶 脐带 接骨木 蕲蛇 重楼	呕吐 胸闷 白带 盗汗 短气 小便不通 半身不遂 消瘦 里急后重 呃逆
硼砂 南天竹 海藻 补骨脂 橄榄 厚朴 黑芝麻 香橼 肉桂 茶叶	恶寒 胁痛 浮肿 积滞 潮热 呕吐 发狂 便血 四肢疼痛 吐血
肉豆蔻 海藻 臭梧桐 玄参 夜明砂 紫石英 柿霜 金沸草 积雪草 鱼腥草	咳嗽 干呕 鼻塞 杨梅疮 五心烦热 瘰疬 恶寒 半身不遂 发黄 恶风
佛手 青风藤 雄黄 全蝎 枇杷 墨旱莲 八角茴香 断血流 山豆根 花椒	头痛 腹痛 烦躁 丹毒 神昏 舌干 小便频数 面色青 麻疹 慢惊
泽泻 枸骨叶 平贝母 枳实 芍药 蝼蛄 红丹 韭子 穿破石 菠菜	吞酸 瘰疬 自汗 腹痛 谵语 心悸 头晕 流泪 咽干 消瘦
益母草 灯盏细辛 沙棘 豌豆 透骨草 龟甲 何首乌 沉香 山慈菇 石榴皮	白带 咳嗽 嗳气 痫 短气 臁疮 恶心 头昏 食欲不振 恶寒
藁本 鬼针草 青葙 海狗肾 虻虫 香薷 卷柏 豹骨 海风藤 儿茶	头痛 痫 肠鸣 短气 吐血 恶心 呃逆 转筋 小便不利 麻疹
千里光 虎杖 枸杞子 降丹 百草霜 紫菀 浙贝母 小茴香 石榴皮 大枣	呕吐 口苦 咳嗽 头晕 便血 恶风 恶寒发热 漏下 消瘦 骨痛
苦木 芫荽 亚麻子 椒目 九里香 万年青 草豆蔻 紫檀 苎麻根 肿节风	呕吐 潮热 恶风 盗汗 气喘 烦躁 反胃 壮热 头昏 项强
牵牛子 琥珀 猪苓 海螵蛸 肉桂 脐带 干姜 苦楝皮 牡丹皮 亚麻子	恶心 无名肿毒 腹满 瘰疬 恶寒 无汗 漏下 神昏 发狂 转筋
凤仙花 酸枣仁 贯众 川楝子 白矾 板蓝根 益母草 荜茇 羌活 西红花	腹痛 恶心 目昏 健忘 崩中 身重 食欲不振 手足厥冷 四肢疼痛 鼻塞
谷精草 鹤草芽 苍耳 厚朴花 蜂房 金钱白花蛇 檀香 穿心莲 半夏 红景天	吐血 痫 小便不通 头痛 慢惊 耳聋 浮肿 头晕 健忘 角弓反张
莳萝 蝉蜕 山茱萸 荔枝核 斑蝥 椒目 牡丹皮 金沸草 枳壳 芒硝	咳嗽 五心烦热 噎膈 吐血 恶寒 谵语 多唾 舌强 目昏 胸闷
爵床 天南星 蝮蛇 芫花 蝉蜕 黄芪 郁金 丁公藤 蜥蜴 紫花杜鹃	腹痛 心烦 慢惊 少气 四肢拘急 畏寒 身痛 谵语 口苦 丹毒
石上柏 仙茅 菠菜 安息香 牛蒡子 浮小麦 马勃 五灵脂 芜荑 大戟	烦躁 浮肿 气喘 赤白带 臁疮 胎动不安 难产 舌强 恶心 咳嗽
臭牡丹 凤仙花 凤凰衣 黑种草子 竹叶 青葙子 桂枝 防己 夜交藤 罂粟	烦躁 盗汗 口渴 鼻衄 胎动不安 疳积 项强 寒热往来 大便秘结 瘰疬
冬葵果 片姜黄 山柰 红大戟 肉苁蓉 水蛭 满山红 土木香 羊蹄 丝瓜络	腰痛 崩漏 舌干 少气 心悸 鼻塞 大便秘结 瘫痪 骨痛 痫
桑叶 橘叶 山楂 煅石膏 荜茇 金钱白花蛇 零陵香 没药 麦门冬 马蔺	咳嗽 头痛 心悸 心下痞 自汗 神昏 腹满 谵语 咽干 身重
山芝麻 酸枣仁 茜草 砒石 苎麻根 雪上一枝蒿 薏苡仁 漏芦 血竭 谷精草	腹痛 小便不利 口噤 慢惊 壮热 难产 心悸 肠鸣 背痛 积滞
龙葵 三叉苦 桑白皮 款冬花 海胆 三棱 沙参 草果 铅丹 车前	咳嗽 盗汗 腹冷 心烦 舌干 发狂 胎毒 吐血 口臭 腹泻
两头尖 明党参 水红花子 秦艽 马宝 红大戟 川芎 川木通 大蒜 糙苏	呕吐 头晕 腰痛 痫 鼻塞 半身不遂 健忘 头痛 胸痛 牙痛
锦灯笼 土鳖虫 鳖甲胶 蘑菇 虻虫 牛蒡 制川乌 桑椹 韭菜子 莨菪	腹痛 壮热 吐血 短气 瘰疬 鼻塞 赤白带 耳聋 咳嗽 脱肛
寻骨风 南沙参 藿香 夏枯草 洋葱 黄精 雷丸 胡椒 白芍 荸荠	白带 口渴 咳嗽 瘰疬 神昏 少气 目昏 急惊 恶心 角弓反张
两面针 苘麻 胖大海 余甘子 木通 石菖蒲 紫河车 九香虫 莲须 独活	头痛 赤白带 耳聋 麻疹 恶寒 浮肿 急惊 目昏 腹泻 腰痛
