干姜 附子 吴茱萸 当归 茴香 木香 牡丹 大黄 牡丹皮 牵牛	腹痛 腹满 腰痛 呕吐 腹冷 消瘦 赤白带 里急后重 面色青 浮肿
茯苓 甘草 半夏 人参 陈皮 白术 桔梗 枳壳 前胡 大腹皮	呕吐 咳嗽 恶风 头重 小便不利 腹痛 浮肿 气喘 反胃 壮热
防风 白芷 川芎 细辛 羌活 荆芥 菊花 枳壳 藜 蒺藜	头痛 目昏 浮肿 鼻塞 头昏 白带 牙痛 流泪 骨痛 皮肤瘙痒
甘草 大黄 茯苓 木通 泽泻 滑石 车前 黄芩 车前子 栀子	小便不通 小便不利 发黄 腹满 浮肿 小便黄赤 烦躁 大便秘结 腹痛 舌苔白
当归 桃 阿胶 桃仁 桑 白芍 红花 蒲黄 地榆 生地黄	吐血 腹痛 鼻衄 便血 崩漏 赤白带 头晕 白带 漏下 大便下血
杏 杏仁 桑 紫菀 麻黄 桔梗 桑白皮 款冬花 五味子 半夏	咳嗽 气喘 短气 浮肿 恶寒 耳聋 胸闷 无汗 头痛 痫
薄荷 桔梗 连翘 甘草 荆芥 黄芩 防风 牛蒡 玄参 金银花	咳嗽 瘰疬 头痛 麻疹 丹毒 谵语 杨梅疮 壮热 舌肿 咽喉痛
柴胡 甘草 芍药 赤芍 黄芩 当归 鳖甲 人参 地骨皮 枳壳	口苦 潮热 舌干 壮热 寒热往来 四肢疼痛 胁痛 腹痛 烦躁 头痛
甘草 人参 麦门冬 麦冬 茯苓 知母 生地黄 玄参 地骨皮 竹茹	咳嗽 心烦 口渴 咽干 吐血 潮热 五心烦热 舌干 盗汗 短气
木香 丁香 豆蔻 藿香 沉香 厚朴 肉豆蔻 砂仁 陈皮 槟榔	呕吐 恶心 腹痛 肠鸣 转筋 呃逆 头痛 吞酸 上吐下泻 胸闷
麝香 朱砂 雄黄 乳香 巴豆 冰片 没药 轻粉 白矾 牛黄	瘰疬 痫 臁疮 无名肿毒 杨梅疮 腹痛 神昏 急惊 难产 发狂
生姜 甘草 人参 半夏 茯苓 白术 厚朴 大枣 桂枝 枳实	呕吐 恶寒 干呕 咳嗽 头痛 腹满 腹痛 心下痞 短气 鼻塞
石膏 甘草 升麻 黄芩 葛根 犀角 麻黄 知母 芍药 柴胡	壮热 头痛 心烦 口渴 咽干 谵语 恶寒 发狂 痫 咳嗽
陈皮 青皮 木香 香附 神曲 厚朴 槟榔 枳壳 砂仁 山楂	恶心 腹痛 吞酸 嘈杂 积滞 呕吐 里急后重 嗳气 噎膈 食欲不振
人参 白术 干姜 附子 甘草 龙骨 牡蛎 茯苓 当归 赤石脂	少气 盗汗 手足厥冷 自汗 腹痛 呕吐 崩中 白带 短气 背痛
防风 羌活 独活 麻黄 细辛 白芷 牛膝 川芎 秦艽 桂枝	头痛 口噤 恶寒 项强 恶风 腰痛 无汗 鼻塞 四肢拘急 四肢麻木
当归 白芍 川芎 白术 甘草 香附 芍药 炙甘草 熟地黄 肉桂	腹痛 自汗 赤白带 头痛 盗汗 难产 白带 崩漏 胁痛 胎动不安
黄连 黄芩 甘草 大黄 黄柏 栀子 竹叶 龙胆 胡黄连 青黛	烦躁 心烦 疳积 口臭 咳嗽 潮热 腹痛 盗汗 吐血 神昏
山药 远志 五味子 茯苓 牛膝 杜仲 菟丝子 山茱萸 人参 熟地黄	腰痛 健忘 耳聋 头晕 白带 目昏 盗汗 心悸 短气 小便频数
附子 天麻 僵蚕 麝香 白附子 朱砂 全蝎 天南星 川乌 牛黄	慢惊 痫 半身不遂 急惊 口噤 神昏 瘫痪 头痛 咳嗽 角弓反张
