甘草 黄芩 人参 柴胡 茯苓 麦门冬 芍药 石膏 升麻 大黄	壮热 烦躁 舌干 发狂 咳嗽 头痛 腹痛 呕吐 心烦 痫
杏 杏仁 款冬花 桑 麻黄 紫菀 半夏 五味子 罂粟 桑白皮	气喘 咳嗽 头痛 呕吐 腹痛 胸闷 鼻塞 壮热 烦躁 恶心
黄连 大黄 栀子 黄芩 茵陈 黄柏 龙胆 郁金 枳实 苦参	腹痛 咳嗽 头痛 呕吐 烦躁 壮热 心烦 发黄 小便不利 痫
甘草 茯苓 半夏 白术 陈皮 人参 木香 厚朴 丁香 砂仁	呕吐 吞酸 反胃 腹泻 咳嗽 上吐下泻 腹痛 头痛 壮热 浮肿
当归 防风 甘草 川芎 川乌 牛膝 附子 羌活 麻黄 白芷	半身不遂 瘫痪 四肢麻木 骨痛 关节疼痛 咳嗽 腹痛 头痛 呕吐 腰膝无力
藜 蒺藜 地榆 白矾 苦参 莲子 青黛 绿豆 牡丹 生地黄	咳嗽 头痛 腹痛 呕吐 烦躁 壮热 心烦 浮肿 痫 吐血
生姜 大枣 葱白 桂枝 赤小豆 瓜蒂 防己 炮姜 薤白 木瓜	咳嗽 腹痛 头痛 呕吐 烦躁 壮热 心烦 腹满 恶寒 鼻塞
茯苓 甘草 白术 桑 人参 当归 陈皮 槟榔 木香 防己	浮肿 小便不利 气喘 咳嗽 腹痛 头痛 呕吐 壮热 痫 烦躁
甘草 当归 黄芩 芍药 人参 阿胶 白芍 茯苓 黄连 生地黄	吐血 便血 鼻衄 咳血 咳嗽 尿血 腹痛 头痛 大便下血 呕吐
甘草 川芎 防风 白芷 羌活 桔梗 麻黄 半夏 荆芥 细辛	头痛 鼻塞 无汗 头昏 咳嗽 腹痛 呕吐 烦躁 壮热 心烦
甘草 木香 厚朴 陈皮 茯苓 枳壳 白术 当归 槟榔 砂仁	腹痛 积滞 里急后重 胸闷 转筋 咳嗽 头痛 呕吐 烦躁 壮热
枇杷 枇杷叶 竹茹 乌梅 瓜蒌 川贝母 麦冬 百部 沙参 款冬花	咳嗽 腹痛 头痛 呕吐 烦躁 气喘 壮热 心烦 浮肿 恶心
附子 干姜 细辛 吴茱萸 乌头 天南星 白附子 川乌 乌梅 皂荚	腹痛 咳嗽 头痛 呕吐 壮热 烦躁 耳聋 手足厥冷 恶心 转筋
麝香 朱砂 附子 全蝎 天麻 僵蚕 牛黄 白附子 甘草 天南星	慢惊 急惊 咳嗽 头痛 呕吐 腹痛 壮热 烦躁 痫 心烦
当归 甘草 茯苓 人参 远志 白芍 五味子 白术 熟地黄 麦冬	头晕 健忘 心悸 多梦 疲乏 食欲不振 不寐 咳嗽 腹痛 头痛
甘草 防风 茯苓 当归 人参 羌活 菊花 川芎 荆芥 黄芩	目昏 流泪 皮肤瘙痒 咳嗽 头痛 腹痛 呕吐 胬肉攀睛 拳毛倒睫 壮热
车前 滑石 木通 车前子 泽泻 猪苓 瞿麦 通草 冬葵 冬葵子	咳嗽 腹痛 头痛 烦躁 小便不通 呕吐 小便不利 浮肿 壮热 心烦
桃 桃仁 红花 大黄 蒲黄 延胡索 赤芍 当归 牛膝 泽兰	腹痛 咳嗽 头痛 呕吐 烦躁 壮热 恶露不下 心烦 浮肿 痫
当归 甘草 川芎 白术 白芍 人参 芍药 茯苓 香附 木香	腹痛 赤白带 面色青 咳嗽 胞衣不下 头痛 呕吐 烦躁 痫 壮热
麝香 冰片 雄黄 朱砂 牛黄 硼砂 蟾酥 青黛 熊胆 珍珠	腹痛 咳嗽 头痛 呕吐 恶心 烦躁 牙痛 壮热 痫 流泪
甘草 人参 白术 当归 茯苓 柴胡 防风 半夏 川芎 黄芩	恶寒 自汗 口苦 手足厥冷 咳嗽 头痛 腹痛 呕吐 烦躁 壮热
甘草 人参 茯苓 当归 柴胡 白术 白芍 芍药 麦门冬 知母	心烦 盗汗 五心烦热 消瘦 咳嗽 腹痛 头痛 呕吐 烦躁 壮热
朱砂 牛黄 麝香 僵蚕 天麻 天竺黄 雄黄 琥珀 全蝎 天南星	咳嗽 神昏 烦躁 壮热 呕吐 头痛 腹痛 气喘 谵语 恶心
甘草 当归 人参 茯苓 柴胡 白术 川芎 芍药 白芍 黄芩	潮热 难产 脱肛 咳嗽 腹痛 头痛 寒战 产后腹痛 呕吐 经行腹痛
使君子 黄连 芦荟 木香 陈皮 槟榔 芜荑 胡黄连 神曲 甘草	疳积 腹痛 咳嗽 食欲不振 消瘦 口臭 头痛 呕吐 壮热 烦躁
大黄 牵牛 槟榔 三棱 郁李 郁李仁 牵牛子 芫花 甘遂 白芥	咳嗽 腹痛 头痛 呕吐 小便不通 痫 腹满 壮热 积滞 恶心
甘草 半夏 茯苓 人参 白术 木香 陈皮 干姜 厚朴 丁香	恶心 肠鸣 腹满 心下痞 干呕 咳嗽 腹痛 头痛 呕吐 小儿呕吐
当归 白术 茯苓 甘草 川芎 白芍 香附 人参 附子 木香	白带 不孕 腹冷 畏寒 胎漏 咳嗽 闭经 腹痛 头痛 月经过多
乳香 没药 川乌 草乌 五灵脂 乌头 地龙 血竭 木鳖子 威灵仙	咳嗽 腹痛 头痛 呕吐 浮肿 赤白带 恶心 壮热 烦躁 痫
硫黄 牡蛎 龙骨 白矾 赤石脂 赭石 石榴 磁石 麻黄根 代赭石	咳嗽 腹痛 头痛 呕吐 痫 壮热 烦躁 白带 心烦 赤白带
甘草 防风 麻黄 当归 茯苓 川芎 白术 人参 芍药 黄芩	恶风 身痛 咳嗽 腹痛 头痛 胸痛 喷嚏 呕吐 舌苔黄 粉刺
甘草 柴胡 黄芩 茯苓 当归 人参 芍药 白术 白芍 半夏	口渴 胁痛 谵语 四肢疼痛 耳聋 头重 咳嗽 腹痛 头痛 足热
甘草 陈皮 茯苓 木香 白术 半夏 香附 厚朴 砂仁 白芍	嘈杂 嗳气 呃逆 噎膈 胃痛 大便溏 咳嗽 舌苔白 口淡 腹痛
甘草 人参 防风 附子 朱砂 麝香 牛黄 当归 天麻 麻黄	痫 口噤 角弓反张 舌强 咳嗽 腹痛 头痛 呕吐 言语错乱 壮热
石膏 竹叶 淡竹 滑石 寒水石 连翘 淡竹叶 竹茹 知母 芦根	咳嗽 头痛 呕吐 腹痛 烦躁 壮热 心烦 口渴 神昏 气喘
甘草 人参 茯苓 当归 白术 干姜 半夏 附子 五味子 芍药	短气 少气 身重 背痛 小便黄赤 咳嗽 多唾 腹痛 头痛 呕吐
甘草 桔梗 半夏 茯苓 人参 桑 陈皮 紫菀 麻黄 五味子	咳嗽 头痛 呕吐 腹痛 壮热 痫 烦躁 妊娠咳嗽 心烦 浮肿
甘草 当归 防风 人参 茯苓 川芎 芍药 柴胡 白术 半夏	项强 寒热往来 四肢拘急 咳嗽 腹痛 臂痛 头痛 呕吐 足痛 腰重
甘草 石膏 黄芩 芍药 柴胡 麦门冬 升麻 栀子 茯苓 赤芍	头痛 小便不通 咳嗽 干呕 腹痛 发黄 呕吐 烦躁 壮热 痫
丹参 黄芪 麦冬 郁金 女贞 三七 党参 女贞子 何首乌 牡蛎	咳嗽 头痛 腹痛 烦躁 心烦 呕吐 胸闷 头昏 浮肿 盗汗
甘草 黄芩 茯苓 桔梗 人参 当归 半夏 柴胡 石膏 升麻	咽干 鼻干 咳嗽 咽喉痛 腹痛 头痛 呵欠 呕吐 喉痒 咳痰
甘草 黄芩 防风 连翘 当归 荆芥 薄荷 桔梗 大黄 黄连	麻疹 大便秘结 丹毒 恶寒发热 牙痛 咳嗽 口臭 腹痛 头痛 痄腮
当归 甘草 杜仲 人参 牛膝 防风 茯苓 附子 川芎 白术	腰痛 神昏 咳嗽 头痛 腹痛 呕吐 烦躁 壮热 产后腰痛 痫
当归 甘草 乳香 没药 白芷 大黄 连翘 麝香 防风 雄黄	瘰疬 无名肿毒 杨梅疮 臁疮 咳嗽 腹痛 头痛 呕吐 小儿丹毒 烦躁
巴豆 朱砂 麝香 雄黄 丁香 檀香 皂荚 巴豆霜 甘松 沉香	腹痛 咳嗽 头痛 呕吐 壮热 痫 烦躁 恶心 赤白带 浮肿
当归 甘草 白术 白芍 阿胶 川芎 芍药 人参 茯苓 香附	崩漏 胎动不安 漏下 崩中 咳嗽 腹痛 头痛 呕吐 恶露不下 烦躁
杏 杏仁 苦杏仁 马兜铃 葶苈子 蜘蛛 干姜 鹤虱 三白草 甲鱼	咳嗽 头痛 呕吐 腹痛 壮热 烦躁 浮肿 心烦 无汗 吐血
薄荷 金银花 菊花 连翘 荷叶 天花粉 樟脑 板蓝根 青蒿 苍耳	咳嗽 头痛 腹痛 鼻塞 呕吐 恶寒 头晕 心烦 烦躁 壮热
豆蔻 丁香 肉豆蔻 木香 茴香 诃子 胡椒 沉香 白豆蔻 草豆蔻	腹痛 咳嗽 头痛 呕吐 积滞 口苦 浮肿 盗汗 气喘 壮热
牛膝 茯苓 五味子 菟丝子 人参 当归 山药 肉苁蓉 杜仲 山茱萸	耳聋 小便频数 头昏 咳嗽 头痛 腰膝无力 腹痛 自汗 遗尿 呕吐
