甘草 当归 黄芩 人参 阿胶 芍药 生地黄 白芍 茯苓 麦门冬	吐血 鼻衄 咳嗽 腹痛 头痛 呕吐 壮热 烦躁 痫 心烦
甘草 木通 滑石 茯苓 车前 当归 黄芩 大黄 瞿麦 车前子	小便不通 小便黄赤 尿血 咳嗽 腹痛 头痛 呕吐 阴疮 壮热 烦躁
地榆 龙骨 赭石 牡蛎 槐花 磁石 白矾 赤石脂 贯众 代赭石	咳嗽 腹痛 头痛 呕吐 痫 烦躁 崩漏 心烦 壮热 目昏
朱砂 僵蚕 麝香 牛黄 天麻 全蝎 附子 天南星 天竺黄 雄黄	咳嗽 急惊 头痛 腹痛 四肢抽搐 呕吐 烦躁 痫 壮热 恶心
甘草 木香 黄连 当归 白术 茯苓 陈皮 槟榔 厚朴 枳壳	里急后重 疳积 脱肛 腹泻 口臭 咳嗽 口淡 腹痛 头痛 呕吐
甘草 石膏 黄芩 芍药 柴胡 人参 麻黄 茯苓 葛根 赤芍	头痛 咳嗽 腹痛 呕吐 壮热 痫 烦躁 恶心 心烦 浮肿
甘草 柴胡 当归 人参 茯苓 黄芩 白术 半夏 陈皮 川芎	恶寒 口苦 胁痛 咳嗽 腹痛 头痛 呕吐 壮热 恶心 烦躁
甘草 防风 附子 当归 人参 芍药 麻黄 茯苓 白术 细辛	口噤 四肢疼痛 舌强 咳嗽 腹痛 头痛 呕吐 善怒 壮热 恶心
当归 防风 甘草 川芎 牛膝 川乌 附子 羌活 麻黄 独活	半身不遂 瘫痪 四肢麻木 骨痛 关节疼痛 腰膝无力 咳嗽 腹痛 头痛 呕吐
甘草 黄芩 柴胡 大黄 人参 石膏 芍药 麻黄 升麻 茯苓	壮热 咳嗽 腹痛 头痛 呕吐 恶心 心烦 痫 烦躁 口中生疮
甘草 人参 茯苓 当归 白术 柴胡 白芍 芍药 知母 川芎	盗汗 潮热 自汗 咳嗽 腹痛 头痛 呕吐 壮热 恶心 浮肿
甘草 当归 人参 茯苓 白术 白芍 柴胡 芍药 黄芩 川芎	心烦 崩漏 消瘦 咳嗽 腹痛 头痛 月经过多 呕吐 壮热 痫
款冬花 百部 桑 紫菀 马兜铃 川贝母 百合 白前 沙参 桑白皮	咳嗽 呕吐 头痛 腹痛 烦躁 鼻塞 浮肿 盗汗 壮热 恶心
杏 杏仁 麻黄 苦杏仁 石膏 知母 旋覆花 紫苏叶 射干 葶苈子	咳嗽 头痛 呕吐 腹痛 鼻塞 浮肿 无汗 烦躁 恶心 心烦
川乌 乌头 草乌 茴香 罂粟 罂粟壳 樟脑 益智 地龙 川楝子	腹痛 咳嗽 头痛 呕吐 恶心 浮肿 壮热 烦躁 盗汗 气喘
甘草 朱砂 人参 牛黄 麝香 大黄 附子 天麻 茯苓 半夏	痫 不寐 咳嗽 腹痛 头痛 呕吐 壮热 烦躁 心烦 浮肿
附子 干姜 硫黄 吴茱萸 皂荚 阳起石 乌头 火麻仁 韭菜 韭菜子	咳嗽 头痛 腹痛 呕吐 自汗 烦躁 恶心 气喘 痫 壮热
甘草 防风 茯苓 当归 人参 菊花 羌活 川芎 黄芩 白术	目昏 流泪 咳嗽 腹痛 头痛 胬肉攀睛 呕吐 远视 拳毛倒睫 壮热
菟丝子 肉苁蓉 鹿茸 五味子 杜仲 山茱萸 枸杞子 牛膝 补骨脂 山药	腰痛 咳嗽 小便频数 腹痛 头痛 遗尿 腰膝无力 头昏 呕吐 食欲不振
甘草 人参 茯苓 当归 白术 干姜 附子 半夏 五味子 麦门冬	短气 少气 咳嗽 胸痛 腰脊痛 腹痛 头痛 呕吐 心下悸 壮热
甘草 当归 茯苓 白术 黄芩 人参 白芍 芍药 黄连 半夏	身重 便血 舌苔白 咳嗽 大便下血 呵欠 小便频数 腹痛 喷嚏 足热
麝香 朱砂 附子 全蝎 天麻 白附子 僵蚕 天南星 人参 牛黄	慢惊 角弓反张 咳嗽 头痛 腹痛 呕吐 恶心 烦躁 痫 壮热
甘草 人参 茯苓 防风 当归 白术 附子 细辛 柴胡 黄芩	恶风 耳聋 背痛 头重 鼻干 腰重 咳嗽 头痛 腹痛 言语错乱
甘草 黄芩 麦冬 连翘 石膏 茯苓 桔梗 黄连 荆芥 防风	口渴 麻疹 谵语 咳嗽 腹痛 头痛 呕吐 喉痒 烦躁 小儿发热
当归 甘草 防风 杜仲 茯苓 牛膝 川芎 独活 人参 附子	腰痛 杨梅疮 角弓反张 皮肤瘙痒 咳嗽 头痛 腹痛 足痛 呕吐 烦躁
甘草 人参 茯苓 半夏 白术 生姜 厚朴 木香 干姜 大黄	腹满 干呕 反胃 咳嗽 多唾 腹痛 头痛 呕吐 烦躁 壮热
藜 白矾 蒺藜 苦参 甘松 苍耳 藜芦 五加 薏苡仁 土茯苓	咳嗽 头痛 腹痛 呕吐 痫 浮肿 心烦 烦躁 恶心 壮热
当归 甘草 乳香 白芷 大黄 连翘 没药 麝香 防风 黄芩	瘰疬 无名肿毒 臁疮 咳嗽 腹痛 头痛 呕吐 壮热 耳痛 心烦
黄芪 丹参 党参 莲子 女贞 何首乌 女贞子 山楂 麦冬 三七	咳嗽 头痛 食欲不振 腹痛 胸闷 烦躁 呕吐 心烦 盗汗 头昏
乌梅 滑石 寒水石 赤小豆 绿豆 百草霜 常山 荷叶 大豆 大麦	咳嗽 腹痛 头痛 呕吐 烦躁 壮热 心烦 恶心 痫 浮肿
甘草 当归 木香 白术 茯苓 厚朴 人参 干姜 陈皮 白芍	腹痛 大便溏 咳嗽 头痛 呕吐 壮热 烦躁 痫 心烦 恶心
甘草 茯苓 杏 杏仁 人参 桔梗 桑 半夏 当归 黄芩	气喘 咽干 咳血 咳嗽 腹痛 头痛 呕吐 头热 壮热 烦躁
乳香 没药 芥子 白芥 白芥子 五灵脂 蓖麻 蓖麻子 威灵仙 血竭	咳嗽 腹痛 头痛 呕吐 壮热 痫 烦躁 恶心 腰痛 浮肿
朱砂 麝香 雄黄 牛黄 天麻 白附子 天南星 全蝎 僵蚕 天竺黄	呕吐 头痛 咳嗽 腹痛 恶心 潮热 气喘 心烦 谵语 目昏
甘草 川芎 防风 白芷 羌活 细辛 半夏 桔梗 荆芥 陈皮	头痛 鼻塞 无汗 咳嗽 腹痛 呕吐 壮热 烦躁 恶心 痫
甘草 陈皮 木香 茯苓 白术 香附 砂仁 厚朴 半夏 神曲	吞酸 积滞 嘈杂 嗳气 呃逆 食欲不振 噎膈 胃痛 咳嗽 头痛
大黄 牵牛 槟榔 郁李 郁李仁 牵牛子 木香 防己 雷丸 瞿麦	咳嗽 腹痛 呕吐 头痛 气喘 浮肿 壮热 痫 心烦 恶心
当归 甘草 茯苓 人参 远志 白芍 白术 五味子 川芎 熟地黄	头晕 健忘 心悸 不孕 多梦 疲乏 畏寒 须发早白 咳嗽 脱发
巴豆 三棱 莪术 芫花 甘遂 干漆 五灵脂 轻粉 大戟 蜈蚣	咳嗽 腹痛 头痛 呕吐 浮肿 壮热 烦躁 痫 恶心 气喘
麝香 雄黄 冰片 丁香 朱砂 蟾酥 沉香 檀香 大黄 木瓜	腹痛 咳嗽 头痛 头晕 呕吐 恶心 胸闷 烦躁 壮热 心烦
甘草 杏仁 杏 桔梗 茯苓 半夏 人参 桑 紫菀 陈皮	咳嗽 腹痛 头痛 呕吐 痫 烦躁 壮热 心烦 白带 瘰疬
甘草 人参 白术 茯苓 附子 当归 防风 半夏 朱砂 麝香	神昏 转筋 手足厥冷 咳嗽 寒战 臂痛 腹痛 头痛 呕吐 但热不寒
当归 甘草 川芎 白术 白芍 人参 茯苓 阿胶 芍药 木香	胎动不安 五心烦热 难产 面色青 咳嗽 产后腹痛 腹痛 头痛 呕吐 经行腹痛
茯苓 甘草 白术 桑 木通 当归 陈皮 人参 泽泻 木香	浮肿 小便不利 咳嗽 腹痛 头痛 呕吐 烦躁 壮热 恶心 白带
甘草 人参 黄芩 茯苓 麦门冬 柴胡 大黄 黄连 芍药 当归	烦躁 舌干 咳嗽 腹痛 头痛 呕吐 壮热 心烦 痫 恶寒
当归 白术 甘草 川芎 白芍 茯苓 香附 人参 芍药 阿胶	白带 漏下 崩中 胎漏 胞衣不下 咳嗽 闭经 腹痛 头痛 恶露不下
茵陈 大黄 栀子 甘草 黄芩 黄连 茯苓 黄柏 泽泻 柴胡	发黄 咳嗽 头痛 腹痛 呕吐 烦躁 肥胖 恶心 壮热 心烦
甘草 人参 白术 干姜 木香 茯苓 当归 附子 半夏 厚朴	肠鸣 腹冷 心下痞 咳嗽 腹痛 头痛 呕吐 小儿呕吐 面色白 小儿腹痛
黄连 胡黄连 使君子 芦荟 芜荑 青黛 麝香 龙胆 熊胆 雷丸	腹痛 咳嗽 壮热 呕吐 头痛 盗汗 疳积 潮热 烦躁 痫
甘草 半夏 茯苓 白术 人参 陈皮 木香 厚朴 丁香 砂仁	呕吐 恶心 上吐下泻 咳嗽 腹痛 头痛 心烦 壮热 烦躁 盗汗
生姜 葱白 大枣 桂枝 薤白 鸡子 通草 麻黄根 丝瓜 饴糖	咳嗽 腹痛 头痛 呕吐 烦躁 恶寒 心烦 壮热 盗汗 恶心
桃 桃仁 红花 蒲黄 延胡索 当归 水蛭 泽兰 大黄 牡丹	腹痛 咳嗽 头痛 呕吐 恶露不下 恶心 壮热 烦躁 浮肿 腰痛
豆蔻 丁香 肉豆蔻 木香 胡椒 白豆蔻 诃子 荜茇 草豆蔻 石榴	腹痛 咳嗽 呕吐 头痛 盗汗 烦躁 浮肿 口苦 壮热 痫
当归 川芎 白芍 甘草 香附 茯苓 白术 附子 人参 木香	赤白带 咳嗽 腹痛 头痛 少腹痛 呕吐 烦躁 痫 产后发热 壮热
冰片 麝香 乳香 轻粉 没药 朱砂 雄黄 硼砂 血竭 儿茶	臁疮 腹痛 咳嗽 头痛 无名肿毒 呕吐 牙痛 杨梅疮 流泪 口臭
甘草 当归 防风 人参 川芎 茯苓 白术 柴胡 羌活 麻黄	项强 寒热往来 头昏 身痛 四肢拘急 咳嗽 腹痛 头痛 呕吐 恶心
竹茹 枇杷 枇杷叶 芦根 麦冬 梨 萝卜 瓜蒌 竹沥 白茅根	咳嗽 头痛 腹痛 呕吐 烦躁 心烦 恶心 壮热 口渴 气喘
甘草 黄芩 防风 大黄 桔梗 当归 连翘 茯苓 陈皮 黄连	胸闷 丹毒 恶寒发热 咳嗽 咽肿 痄腮 舌苔黄 牙龈肿痛 腹痛 头痛
连翘 牛蒡 竹叶 金银花 牛蒡子 薄荷 淡竹 淡竹叶 荆芥 菊花	咳嗽 头痛 鼻塞 腹痛 恶寒 呕吐 心烦 头晕 痫 壮热
甘草 大黄 黄芩 当归 石膏 黄连 薄荷 防风 升麻 连翘	大便秘结 牙痛 发狂 咳嗽 咽喉痛 胎毒 舌肿 头痛 腹痛 呕吐
