甘草 茯苓 黄芩 茵陈 大黄 柴胡 人参 白术 栀子 芍药	小便不利 谵语 咳嗽 发黄 腹痛 小便黄赤 头痛 呕吐 痫 烦躁
厚朴 陈皮 藿香 半夏 苍术 神曲 枳壳 茯苓 山楂 麦芽	腹痛 头痛 咳嗽 恶寒 口渴 肠鸣 胸闷 转筋 壮热 呕吐
甘草 当归 防风 大黄 连翘 白芷 黄芩 荆芥 川芎 赤芍	瘰疬 丹毒 无名肿毒 杨梅疮 皮肤瘙痒 咳嗽 头痛 腹痛 呕吐 呵欠
槟榔 木香 青皮 陈皮 莪术 三棱 神曲 大黄 山楂 麦芽	积滞 腹痛 咳嗽 疳积 头痛 烦躁 痫 呕吐 消瘦 大便秘结
甘草 川芎 防风 羌活 白芷 麻黄 桔梗 细辛 荆芥 柴胡	头痛 鼻塞 恶寒 无汗 咳嗽 身痛 腹痛 头昏 呕吐 烦躁
干姜 附子 乌头 细辛 吴茱萸 硫黄 龙骨 牡蛎 川乌 赤石脂	腹痛 咳嗽 头痛 呕吐 壮热 短气 烦躁 心烦 腰痛 恶寒
当归 茯苓 甘草 人参 远志 白术 五味子 白芍 熟地黄 山药	头晕 健忘 心悸 食欲不振 多梦 头昏 疲乏 畏寒 咳嗽 腹痛
当归 甘草 茯苓 川芎 白术 芍药 人参 陈皮 木香 香附	浮肿 胁痛 咳嗽 腹冷 难产 头痛 腰痛 腹痛 胞衣不下 呕吐
石膏 甘草 黄芩 升麻 知母 柴胡 麦门冬 犀角 葛根 赤芍	头痛 咳嗽 痫 口渴 腹痛 恶寒 呕吐 麻疹 心烦 口苦
白附子 附子 天麻 天南星 全蝎 僵蚕 麝香 朱砂 防风 半夏	痫 慢惊 神昏 头痛 咳嗽 急惊 壮热 腹痛 呕吐 烦躁
木香 丁香 沉香 麝香 细辛 乌梅 檀香 薄荷 冰片 郁金	腹痛 咳嗽 头痛 呕吐 痫 壮热 恶心 烦躁 头晕 瘰疬
甘草 桔梗 半夏 茯苓 陈皮 前胡 五味子 枳壳 黄芩 知母	咳嗽 气喘 腹痛 头痛 呕吐 烦躁 恶寒 胸闷 壮热 痫
桃 桃仁 蒲黄 红花 当归 大黄 牡丹 赤芍 牡丹皮 延胡索	腹痛 咳嗽 头痛 呕吐 心烦 烦躁 腰痛 壮热 恶寒 恶心
甘草 黄芩 石膏 茯苓 桔梗 当归 人参 黄连 薄荷 玄参	咽干 发狂 咳嗽 牙痛 头痛 腹痛 咳血 咽喉痛 呕吐 舌肿
木香 豆蔻 丁香 肉豆蔻 附子 茴香 诃子 槟榔 胡椒 益智	腹痛 肠鸣 咳嗽 头痛 呕吐 气喘 浮肿 盗汗 烦躁 腹冷
麦冬 丹参 沙参 黄芪 山药 党参 牡蛎 石菖蒲 三七 白芍	咳嗽 头痛 烦躁 腹痛 心烦 口渴 吐血 呕吐 痫 盗汗
牛膝 杜仲 当归 茯苓 菟丝子 五味子 人参 防风 肉苁蓉 附子	腰痛 耳聋 咳嗽 小便频数 腹痛 头痛 腰膝无力 浮肿 烦躁 盗汗
甘草 人参 当归 茯苓 白术 芍药 麦门冬 五味子 半夏 黄芩	短气 吐血 少气 神昏 咳嗽 头痛 腹痛 脱肛 鼻衄 呕吐
当归 白芍 川芎 白术 甘草 香附 茯苓 人参 附子 阿胶	白带 赤白带 崩漏 不孕 漏下 咳嗽 胎漏 腹痛 头痛 闭经
甘草 陈皮 木香 茯苓 半夏 香附 白术 厚朴 砂仁 人参	吞酸 口苦 嘈杂 嗳气 呃逆 咳嗽 噎膈 胃痛 腹痛 头痛
甘草 茯苓 半夏 白术 人参 陈皮 木香 厚朴 丁香 藿香	呕吐 反胃 腹泻 咳嗽 大便溏 腹痛 头痛 烦躁 壮热 痫
甘草 黄芩 柴胡 人参 麦门冬 芍药 石膏 大黄 茯苓 升麻	壮热 烦躁 舌干 咳嗽 腹痛 头痛 呕吐 心烦 痫 恶寒
木通 滑石 车前 车前子 泽泻 大黄 黄芩 瞿麦 栀子 猪苓	咳嗽 腹痛 头痛 小便不通 呕吐 烦躁 浮肿 心烦 口渴 壮热
甘草 人参 当归 茯苓 白术 柴胡 白芍 芍药 川芎 半夏	潮热 自汗 恶寒发热 咳嗽 面色青 头痛 腹痛 不寐 呕吐 痫
巴豆 大黄 牵牛 槟榔 防己 郁李 郁李仁 藜 甘遂 皂荚	咳嗽 腹痛 头痛 呕吐 浮肿 壮热 痫 烦躁 气喘 恶心
生姜 大枣 桂枝 竹茹 葱白 生地黄 麻黄 甘草 芍药 小麦	咳嗽 头痛 腹痛 呕吐 恶寒 烦躁 壮热 心烦 浮肿 腰痛
杏 杏仁 麻黄 苦杏仁 罂粟 罂粟壳 紫苏子 葶苈子 青蒿 紫苏叶	咳嗽 头痛 腹痛 呕吐 浮肿 烦躁 壮热 痫 恶寒 心烦
当归 甘草 白术 白芍 人参 芍药 川芎 茯苓 干姜 阿胶	腹痛 胎动不安 崩中 里急后重 咳嗽 便血 头痛 呕吐 壮热 烦躁
桑 紫菀 桑白皮 款冬花 百合 枇杷 阿胶 枇杷叶 百部 天门冬	咳嗽 头痛 呕吐 腹痛 烦躁 心烦 浮肿 气喘 壮热 鼻塞
黄连 大黄 栀子 胡黄连 黄柏 青黛 芦荟 龙胆 地榆 芜荑	咳嗽 腹痛 头痛 痫 心烦 呕吐 壮热 烦躁 吐血 盗汗
乳香 没药 轻粉 血竭 草乌 白芷 川乌 麝香 地龙 白及	腹痛 咳嗽 头痛 臁疮 呕吐 腰痛 瘰疬 壮热 痫 烦躁
甘草 半夏 茯苓 人参 白术 陈皮 木香 厚朴 干姜 丁香	恶心 腹满 干呕 心下痞 咳嗽 腹痛 头痛 口淡 呕吐 多唾
牛黄 朱砂 天竺黄 琥珀 钩藤 雄黄 麝香 僵蚕 冰片 天麻	咳嗽 烦躁 呕吐 头痛 神昏 腹痛 急惊 痫 壮热 谵语
连翘 薄荷 荆芥 牛蒡 竹叶 金银花 牛蒡子 淡竹 桔梗 防风	咳嗽 头痛 麻疹 口渴 恶寒 腹痛 鼻塞 心烦 呕吐 大便秘结
当归 防风 川芎 甘草 牛膝 附子 羌活 川乌 麻黄 独活	半身不遂 瘫痪 四肢麻木 骨痛 咳嗽 关节疼痛 腹痛 头痛 呕吐 足痛
甘草 防风 茯苓 当归 人参 菊花 川芎 黄芩 羌活 芍药	目昏 流泪 咳嗽 头痛 腹痛 呕吐 鼻干 远视 烦躁 壮热
麝香 朱砂 雄黄 白矾 牛黄 冰片 青黛 蟾酥 轻粉 硼砂	咳嗽 腹痛 头痛 呕吐 痫 恶心 壮热 瘰疬 无名肿毒 烦躁
甘草 人参 当归 茯苓 柴胡 白术 芍药 白芍 黄芩 川芎	心烦 盗汗 寒热往来 五心烦热 消瘦 咳嗽 头痛 腹痛 呕吐 壮热
甘草 防风 人参 当归 麻黄 附子 白术 茯苓 芍药 羌活	口噤 恶风 项强 四肢疼痛 角弓反张 四肢拘急 背痛 舌强 咳嗽 头重
人参 甘草 白术 茯苓 当归 芍药 干姜 白芍 肉桂 附子	咳嗽 头痛 恶寒 肠鸣 痫 腹痛 气喘 慢惊 身重 烦躁
