角色0 ： 人参 白术 茯苓 半夏 甘草 陈皮 枳壳 黄连 干姜 生姜  角色1 ： 半夏 茯苓 甘草 陈皮 白术 大黄 鳖甲 乌药 大麦 肉桂  角色2 ： 甘草 人参 白术 茯苓 肉桂 当归 酸枣仁 枳实 芍药 羚羊角  角色3 ： 人参 茯苓 白术 甘草 五味子 干姜 白薇 附子 白矾 薤白	咳嗽 头痛 腹满 潮热 消瘦 盗汗 烦躁 咽干 心烦 头昏
角色0 ： 羚羊角 麦门冬 升麻 犀角 地骨皮 柴胡 龙齿 白鲜皮 寒水石 栀子  角色1 ： 知母 麦门冬 柴胡 甘草 石膏 升麻 黄芩 犀角 葛根 生地黄  角色2 ： 黄芩 麦门冬 犀角 甘草 升麻 石膏 寒水石 大黄 芍药 白鲜皮  角色3 ： 升麻 犀角 玄参 射干 黄芩 石膏 羚羊角 龙胆 前胡 栀子	烦躁 壮热 咽喉痛 舌干 丹毒 潮热 牙龈肿痛 寒战 大便秘结 口噤
角色0 ： 紫菀 款冬花 百合 百部 白前 马兜铃 蛤蚧 五味子 杏仁 麻黄  角色1 ： 杏仁 杏 苦杏仁 紫苏子 葶苈子 紫苏叶 浙贝母 天门冬 夏枯草 半夏  角色2 ： 杏仁 杏 麻黄 射干 白果 紫苏叶 青黛 乌头 皂荚 鸡子  角色3 ： 杏仁 杏 皂荚 紫苏叶 款冬花 桑 硫黄 白芷 浙贝母 白鲜皮	咳嗽 气喘 咳痰 喉痒 妊娠咳嗽 咽干 身重 胸痛 舌裂 鼻塞
角色0 ： 青皮 木香 香附 砂仁 姜黄 五灵脂 三棱 陈皮 片姜黄 连翘  角色1 ： 陈皮 青皮 槟榔 木香 枳壳 厚朴 砂仁 半夏 沉香 香附  角色2 ： 木香 槟榔 青皮 丁香 沉香 陈皮 萝卜 牵牛 巴豆 草果  角色3 ： 三棱 莪术 青皮 干漆 阿魏 巴豆 牵牛 胡椒 萝卜 乌梅	积滞 恶心 呕吐 腹满 吞酸 寒热往来 大便溏 疳积 口臭 胁痛
角色0 ： 牵牛 槟榔 大黄 牵牛子 枳实 木香 雄黄 紫苏子 椒目 百合  角色1 ： 郁李 郁李仁 防己 槟榔 桑 木通 大腹皮 甘遂 泽漆 茴香  角色2 ： 槟榔 木香 枳壳 大腹皮 木通 青礞石 泽泻 秦艽 阿魏 附子  角色3 ： 木香 枳壳 槟榔 陈皮 商陆 人参 木瓜 大腹皮 萝卜 皂荚	浮肿 气喘 大便秘结 腹满 烦躁 腰重 咳嗽 身重 月经过多 带状疱疹
角色0 ： 甘草 麦门冬 地骨皮 人参 芍药 知母 茯苓 薄荷 乌梅 薏苡仁  角色1 ： 柴胡 鳖甲 地骨皮 秦艽 知母 青蒿 白芷 天门冬 玄参 海藻  角色2 ： 甘草 知母 柴胡 麦门冬 黄芩 石膏 枳壳 生地黄 人参 犀角  角色3 ： 芍药 赤芍 枳壳 当归 知母 白芍 赤石脂 苍术 人参 射干	心烦 五心烦热 潮热 四肢疼痛 寒热往来 口渴 汗血 不寐 心悸 身重
角色0 ： 乳香 轻粉 没药 麝香 蓖麻 松香 穿山甲 蓖麻子 蜂房 蛇蜕  角色1 ： 白芷 白及 白蔹 斑蝥 五倍子 赤小豆 海藻 昆布 连翘 夏枯草  角色2 ： 乳香 没药 五灵脂 地龙 木鳖子 自然铜 草乌 骨碎补 虎骨 甜瓜  角色3 ： 乳香 没药 血竭 轻粉 儿茶 冰片 穿山甲 阿魏 樟脑 象皮	瘰疬 臁疮 无名肿毒 烦躁 便血 胞衣不下 唇肿 肥胖 喉痒 胃痛
角色0 ： 黄芩 黄连 栀子 大黄 黄柏 石膏 寒水石 白术 知母 蔓荆子  角色1 ： 大黄 黄芩 栀子 黄连 苦参 枳实 丹参 地骨皮 鸡子 麦门冬  角色2 ： 竹叶 淡竹 淡竹叶 连翘 薄荷 木通 栀子 石膏 通草 紫苏叶  角色3 ： 黄芩 黄连 栀子 大黄 郁金 龙胆 玄参 石膏 白茅根 葱白	烦躁 谵语 发狂 大便秘结 口渴 神昏 舌肿 漏下 咳血 干呕
角色0 ： 何首乌 女贞 女贞子 枸杞子 熟地黄 黄芪 菟丝子 黄精 制何首乌 桑椹  角色1 ： 丹参 五味子 麦冬 罂粟壳 罂粟 三七 郁金 当归 夏枯草 泽兰  角色2 ： 远志 石菖蒲 酸枣仁 柏子仁 五味子 熟地黄 龙齿 丹参 知母 附子  角色3 ： 山药 党参 黄芪 芡实 莲子 大枣 龙眼肉 龙眼 薏苡仁 玉竹	头晕 心悸 健忘 多梦 胸闷 疲乏 食欲不振 须发早白 脱发 小便频数
角色0 ： 白芍 当归 川芎 熟地黄 炙甘草 生姜 三七 生地黄 樟脑 苍术  角色1 ： 当归 芍药 川芎 白芍 阿胶 茜草 肉桂 益母草 石斛 香附  角色2 ： 阿胶 艾叶 续断 地榆 蒲黄 小蓟 黄柏 肉桂 杜仲 砂仁  角色3 ： 当归 阿胶 川芎 白芍 炙甘草 艾叶 蒲黄 赤石脂 侧柏叶 荆芥	崩漏 胎动不安 漏下 崩中 胎漏 尿血 吐血 心烦 胎毒 头晕
角色0 ： 黄连 青黛 龙胆 胡黄连 芦荟 麝香 熊胆 瓜蒂 芜荑 使君子  角色1 ： 柴胡 鳖甲 秦艽 地骨皮 青蒿 乌梅 常山 知母 茯苓 银柴胡  角色2 ： 黄连 使君子 胡黄连 芜荑 芦荟 雷丸 鹤虱 熊胆 夜明砂 鸡内金  角色3 ： 柴胡 芥子 白芥 白芥子 甘草 半夏 青皮 青黛 郁金 沉香	潮热 盗汗 消瘦 疳积 鼻痒 面色青 口臭 小儿腹痛 言语错乱 脱肛
角色0 ： 桑 桑寄生 桑叶 桑螵蛸 桑枝 蚕砂 羌活 骨碎补 大黄 乌梅  角色1 ： 桑 五味子 桑白皮 紫菀 款冬花 皂荚 白石英 紫苏叶 射干 百合  角色2 ： 桑 桑白皮 天门冬 桔梗 紫菀 桑叶 马兜铃 大腹皮 板蓝根 前胡  角色3 ： 杏 杏仁 麻黄 桔梗 紫苏叶 牛膝 虎杖 琥珀 砂仁 半夏	咳嗽 气喘 寒热往来 舌肿 赤脉传睛 鼻衄 骨痛 丹毒 腹泻 尿血
角色0 ： 甘草 茯苓 当归 半夏 柴胡 生姜 葛根 石决明 乌梅 陈皮  角色1 ： 甘草 当归 人参 麻黄 桔梗 石膏 白术 芍药 延胡索 地骨皮  角色2 ： 甘草 白术 桔梗 炙甘草 生姜 生地黄 干姜 泽兰 川贝母 半夏  角色3 ： 茯苓 人参 半夏 甘草 苍术 冬瓜 当归 陈皮 炙甘草 续断	头痛 神昏 壮热 鼻塞 脱肛 烦躁 腹满 咽干 痫 头昏
角色0 ： 滑石 木通 黄芩 甘草 木香 白芍 葱白 陈皮 乳香 黄连  角色1 ： 大黄 甘草 黄芩 木通 郁金 大豆 巴豆 生姜 生地黄 茯苓  角色2 ： 大黄 甘草 黄芩 石膏 寒水石 芍药 赤芍 瓜蒂 桔梗 青黛  角色3 ： 滑石 木通 瞿麦 冬葵 冬葵子 通草 石韦 白茅根 滑石粉 海金沙	小便不通 小便不利 尿血 腹满 阴疮 鼻干 四肢拘急 发黄 妊娠小便不通 不射精
角色0 ： 人参 茯苓 白术 甘草 陈皮 乌梅 厚朴 芍药 干姜 荆芥  角色1 ： 肉桂 白术 当归 干姜 吴茱萸 人参 硫黄 牡蛎 龟甲 黄连  角色2 ： 附子 干姜 细辛 人参 木香 白术 山药 梨 炮姜 芍药  角色3 ： 益智 益智仁 甘草 干姜 木香 丁香 石菖蒲 大豆 石斛 肉桂	腹痛 遗尿 畏寒 肠鸣 呕吐 腹泻 脱肛 少气 小儿遗尿 胁痛
角色0 ： 甘草 黄芩 柴胡 知母 葛根 栀子 龙胆 桔梗 川芎 生地黄  角色1 ： 甘草 黄芩 柴胡 芍药 赤芍 白芍 附子 厚朴 茴香 生姜  角色2 ： 芍药 赤芍 当归 甘草 大黄 苏木 石菖蒲 枳壳 威灵仙 桂枝  角色3 ： 柴胡 黄芩 甘草 当归 桔梗 白芍 人参 苦参 地骨皮 升麻	口苦 舌干 胁痛 寒热往来 咽干 但热不寒 心烦 气喘 寒战 咳痰
角色0 ： 当归 木瓜 白鲜皮 土茯苓 金银花 防己 牛膝 薏苡仁 川芎 麻黄  角色1 ： 防风 羌活 独活 秦艽 木瓜 牛膝 玉竹 川乌 威灵仙 人参  角色2 ： 川乌 威灵仙 草乌 红花 牛膝 桂枝 独活 地龙 骨碎补 马钱  角色3 ： 苍术 白芷 川芎 防风 苦参 何首乌 羌活 乌药 蔓荆子 荆芥	半身不遂 杨梅疮 瘫痪 骨痛 四肢麻木 关节疼痛 皮肤瘙痒 转筋 腹痛 背痛
角色0 ： 香附 乌药 砂仁 川芎 沉香 白芍 附子 黄连 马蔺 紫石英  角色1 ： 当归 白芍 川芎 熟地黄 肉桂 蒲黄 丹参 防风 炮姜 白术  角色2 ： 香附 益母草 延胡索 当归 川芎 丹参 木香 泽兰 五灵脂 姜黄  角色3 ： 白芍 当归 川芎 肉桂 白薇 橘红 香附 党参 阿胶 白石英	腹痛 不孕 头晕 闭经 胁痛 产后腹痛 胞衣不下 经行腹痛 胃痛 肠鸣
角色0 ： 甘草 人参 白术 当归 紫河车 附子 茯苓 木香 绿豆 郁金  角色1 ： 白术 人参 茯苓 当归 生地黄 皂荚 赤小豆 五味子 陈皮 白芍  角色2 ： 麻黄 人参 麦门冬 牡蛎 大枣 小麦 麻黄根 浮小麦 白矾 酸枣仁  角色3 ： 甘草 茯苓 白术 人参 炙甘草 白芍 当归 陈皮 牛膝 地骨皮	自汗 盗汗 少气 不寐 咳嗽 潮热 头昏 角弓反张 妊娠呕吐 小便不利
角色0 ： 附子 干姜 细辛 半夏 吴茱萸 肉桂 当归 草乌 白术 牡蛎  角色1 ： 乌头 川乌 草乌 五灵脂 白矾 两头尖 地榆 前胡 干姜 吴茱萸  角色2 ： 细辛 麻黄 附子 防风 乌头 吴茱萸 独活 人参 天南星 生姜  角色3 ： 防风 防己 麻黄 秦艽 独活 细辛 竹沥 木通 甘草 茯苓	口噤 角弓反张 半身不遂 瘫痪 恶风 壮热 项强 腰重 牙痛 背痛
角色0 ： 半夏 苍术 陈皮 厚朴 藿香 草果 甘草 干姜 槟榔 神曲  角色1 ： 半夏 陈皮 茯苓 厚朴 枳实 白术 木香 肉桂 党参 香附  角色2 ： 苍术 厚朴 陈皮 甘草 藿香 砂仁 肉桂 鹿角 猪牙皂 赭石  角色3 ： 半夏 陈皮 甘草 枳实 茯苓 白术 枳壳 藿香 五味子 香附	呕吐 恶心 舌疮 头晕 臂痛 大便秘结 小儿丹毒 漏睛 便血 小儿口疮
角色0 ： 当归 白芍 芍药 炙甘草 黄芩 陈皮 连翘 柴胡 甘草 续断  角色1 ： 当归 白芍 川芎 芍药 石斛 羌活 枳实 地榆 知母 天麻  角色2 ： 当归 川芎 甘草 白术 炮姜 芍药 肉桂 熟地黄 姜黄 刘寄奴  角色3 ： 白芍 当归 川芎 甘草 白术 陈皮 香附 炙甘草 熟地黄 附子	腹痛 胁痛 心烦 少腹痛 肠鸣 畏寒 干呕 吐血 舌强 胎毒
角色0 ： 麝香 白矾 雄黄 轻粉 朱砂 青黛 巴豆 天门冬 胆矾 犀角  角色1 ： 巴豆 朱砂 猪牙皂 麝香 皂荚 巴豆霜 青黛 雄黄 郁金 大黄  角色2 ： 冰片 硼砂 牛黄 珍珠 青黛 炉甘石 熊胆 玄明粉 儿茶 人中白  角色3 ： 麝香 雄黄 朱砂 蟾酥 冰片 丁香 牛黄 蜈蚣 青黛 白鲜皮	牙痛 痫 慢惊 口臭 急惊 湿疮 胎毒 无名肿毒 流泪 胬肉攀睛
角色0 ： 甘草 茯苓 半夏 白术 陈皮 炙甘草 芍药 五味子 人参 羚羊角  角色1 ： 甘草 白术 人参 干姜 芍药 细辛 生姜 香附 桔梗 肉桂  角色2 ： 人参 茯苓 甘草 白术 生姜 半夏 泽泻 乳香 茵陈 枳壳  角色3 ： 人参 茯苓 白术 肉桂 绿豆 半夏 酸枣仁 金樱子 莲子 龙骨	短气 自汗 呕吐 背痛 恶心 头晕 腹冷 少气 鼻干 四肢疼痛
角色0 ： 人参 远志 石菖蒲 麦门冬 生地黄 附子 葱白 山茱萸 沉香 磁石  角色1 ： 山药 山茱萸 泽泻 熟地黄 五味子 石斛 肉桂 柏子仁 白术 石菖蒲  角色2 ： 五味子 茯苓 麦门冬 磁石 人参 远志 全蝎 紫菀 甘草 槐角  角色3 ： 麦门冬 天门冬 五味子 生地黄 人参 地骨皮 柏子仁 白石英 麦冬 山药	耳聋 少气 盗汗 健忘 头昏 自汗 头重 便血 崩漏 善怒
角色0 ： 黄连 黄柏 黄芩 枳壳 阿胶 栀子 大黄 地榆 芍药 苍术  角色1 ： 当归 黄连 黄芩 白芍 黄柏 生地黄 大黄 蒲黄 白矾 三七  角色2 ： 乌梅 地榆 诃子 槐花 当归 白矾 槐角 侧柏叶 薤白 寒水石  角色3 ： 黄连 黄柏 生地黄 黄芩 芍药 茯苓 肉桂 乌头 犀角 牡蛎	吐血 里急后重 便血 脱肛 大便下血 胞衣不下 脐疮 寒热往来 丹毒 瘰疬
角色0 ： 甘草 人参 麦门冬 附子 黄连 枳实 半夏 使君子 荸荠 葛根  角色1 ： 人参 茯苓 当归 郁金 前胡 大黄 知母 天门冬 酸枣仁 通草  角色2 ： 甘草 茯苓 陈皮 人参 防风 赤芍 芍药 白薇 天冬 柴胡  角色3 ： 白术 茯苓 人参 半夏 高良姜 地骨皮 陈皮 生姜 荆芥 黄芪	心烦 烦躁 短气 咽干 谵语 口淡 不寐 咳嗽 寒热往来 瘰疬
角色0 ： 干姜 吴茱萸 石榴 附子 石榴皮 硫黄 高良姜 黄柏 白头翁 马齿苋  角色1 ： 干姜 附子 厚朴 吴茱萸 人参 草果 青蒿 牡荆 橘红 诃子  角色2 ： 附子 吴茱萸 干姜 肉桂 丁香 硫黄 厚朴 猪牙皂 小麦 牡蛎  角色3 ： 附子 干姜 肉桂 硫黄 当归 吴茱萸 芍药 木香 木瓜 白术	腹痛 腹冷 转筋 手足厥冷 面色青 上吐下泻 呃逆 浮肿 舌肿 崩漏
角色0 ： 神曲 山楂 麦芽 陈皮 砂仁 青皮 鸡内金 谷芽 莱菔子 肉桂  角色1 ： 陈皮 香附 砂仁 青皮 厚朴 苍术 半夏 草果 佛手 川芎  角色2 ： 神曲 山楂 麦芽 枳实 莱菔子 大麦 香附 厚朴 木香 陈皮  角色3 ： 藿香 厚朴 砂仁 香薷 广藿香 苍术 白扁豆 陈皮 草果 枳实	吞酸 呕吐 嘈杂 嗳气 食欲不振 腹泻 胸闷 胃痛 舌苔白 口臭
角色0 ： 半夏 生姜 厚朴 白术 人参 葱白 陈皮 射干 菊花 艾叶  角色1 ： 生姜 竹茹 芦根 半夏 枳实 陈皮 葛根 竹沥 木瓜 地骨皮  角色2 ： 人参 甘草 白术 陈皮 半夏 藿香 决明子 乌药 荆芥 桑枝  角色3 ： 半夏 陈皮 生姜 厚朴 茯苓 藿香 乌梅 枳壳 大枣 川芎	呕吐 干呕 呃逆 心下痞 身痛 阴挺 头晕 小儿呕吐 项强 不孕
角色0 ： 甘草 茯苓 枳壳 当归 藿香 雷丸 石膏 白术 枸杞子 耳草  角色1 ： 甘草 茯苓 人参 当归 白芍 木香 川芎 巴豆 生地黄 白术  角色2 ： 车前 车前子 青皮 车前草 梨 土茯苓 浮萍 冬瓜 王不留行 百合  角色3 ： 茯苓 白术 甘草 陈皮 炙甘草 柴胡 酸枣仁 荆芥 牡蛎 天门冬	腹痛 难产 小便不利 目昏 气喘 小便黄赤 腹泻 发狂 头热 尿血
角色0 ： 桃 桃仁 水蛭 虻虫 核桃仁 安息香 蒲黄 鬼箭羽 琥珀 独活  角色1 ： 藜 蒺藜 菊花 石决明 木贼 藜芦 青葙 青葙子 决明子 茺蔚子  角色2 ： 红花 当归 赤芍 牛膝 苏木 蒲黄 刘寄奴 石膏 地龙 苦参  角色3 ： 桃 桃仁 红花 当归 泽兰 瓜蒌 鳖甲 白芷 穿山甲 大黄	目昏 流泪 皮肤瘙痒 胸痛 头昏 恶露不下 大便秘结 远视 吐血 粉刺
角色0 ： 天南星 白附子 附子 天麻 僵蚕 麝香 全蝎 蝉蜕 琥珀 丹参  角色1 ： 僵蚕 天麻 全蝎 白附子 蝉蜕 牛胆 胆南星 天竺黄 钩藤 枳壳  角色2 ： 附子 白附子 天南星 天麻 僵蚕 全蝎 麝香 鳖甲 牛黄 木瓜  角色3 ： 全蝎 蜈蚣 天麻 朱砂 僵蚕 麝香 雄黄 紫苏叶 吴茱萸 牛膝	慢惊 急惊 痫 神昏 角弓反张 舌强 壮热 目昏 足热 头胀
角色0 ： 知母 甘草 黄柏 白芍 麦门冬 乌梅 地骨皮 白术 黄连 附子  角色1 ： 玄参 麦冬 知母 甘草 天花粉 丹参 大黄 苦参 天冬 胡椒  角色2 ： 麦冬 沙参 天冬 北沙参 百合 梨 玉竹 南沙参 石斛 浙贝母  角色3 ： 麦冬 玄参 天花粉 莲子 知母 天门冬 莲子心 犀角 山豆根 黄柏	口渴 咽干 心烦 舌干 咳血 自汗 消瘦 咽肿 小儿发热 嘈杂
角色0 ： 甘草 麻黄 桂枝 石膏 葱白 苍术 茯苓 陈皮 防风 柏子仁  角色1 ： 甘草 人参 生姜 茯苓 枳壳 半夏 瓜蒌 麻黄 当归 附子  角色2 ： 生姜 大枣 桂枝 葱白 半夏 木香 炙甘草 麻黄 大麦 瓜蒌  角色3 ： 甘草 桂枝 芍药 麻黄 陈皮 人参 丁香 黄芩 瓜蒂 天花粉	恶寒 无汗 恶风 身痛 呕吐 身重 小儿发热 血精 壮热 骨痛
角色0 ： 菟丝子 肉苁蓉 鹿茸 蛇床子 五味子 石斛 覆盆子 山茱萸 远志 柏子仁  角色1 ： 鹿角 山药 枸杞子 鹿角胶 菟丝子 熟地黄 牛膝 鹿角霜 补骨脂 淫羊藿  角色2 ： 杜仲 牛膝 续断 狗脊 山药 补骨脂 肉苁蓉 鹿茸 虎骨 雄黄  角色3 ： 杜仲 牛膝 菟丝子 肉苁蓉 补骨脂 山茱萸 石斛 巴戟天 鹿茸 枸杞子	腰痛 小便频数 不孕 腰膝无力 头昏 腰脊痛 产后腰痛 远视 畏寒 腰重
角色0 ： 赤石脂 硫黄 附子 龙骨 赭石 禹余粮 代赭石 紫石英 牡蛎 鹿茸  角色1 ： 当归 香附 肉桂 白芍 熟地黄 艾叶 白薇 川芎 人参 大黄  角色2 ： 龙骨 牡蛎 赤石脂 海螵蛸 山药 桑 禹余粮 黄柏 皂矾 菟丝子  角色3 ： 茴香 小茴香 川楝子 沉香 葫芦 胡芦巴 八角茴香 黄柏 当归 远志	白带 赤白带 崩中 目昏 小便不利 漏下 干呕 耳聋 尿后余沥 善惊
角色0 ： 荆芥 防风 羌活 桔梗 甘草 独活 川芎 白芷 麻黄 胡椒  角色1 ： 防风 羌活 细辛 苍术 白芷 麻黄 枳壳 附子 苦参 柴胡  角色2 ： 川芎 白芷 苍术 细辛 防风 薄荷 白矾 陈皮 干姜 甘草  角色3 ： 羌活 防风 川芎 白芷 荆芥 独活 甘草 生地黄 厚朴 前胡	恶寒 头痛 恶寒发热 身痛 无汗 舌苔白 产后血崩 舌疮 瞳神散大 四肢拘急
角色0 ： 前胡 旋覆花 桔梗 枳壳 半夏 芍药 木通 吴茱萸 生姜 茴香  角色1 ： 甘草 半夏 桔梗 枳壳 前胡 陈皮 天花粉 茯苓 紫苏叶 荆芥  角色2 ： 枳壳 桔梗 前胡 陈皮 半夏 麻黄 白矾 旋覆花 细辛 大腹皮  角色3 ： 桔梗 枳壳 甘草 前胡 紫苏叶 射干 半夏 乌梅 巴豆 附子	咳嗽 头痛 鼻塞 多唾 目昏 胃痛 心下悸 恶寒 干呕 咽干
角色0 ： 薄荷 荷叶 荆芥 苦参 穿山甲 生地黄 防风 皂荚 郁李 马齿苋  角色1 ： 牛蒡 牛蒡子 连翘 荆芥 淡豆豉 金银花 大青叶 升麻 薄荷 桔梗  角色2 ： 连翘 荆芥 蝉蜕 桔梗 防风 紫草 僵蚕 薄荷 紫草茸 天麻  角色3 ： 连翘 金银花 薄荷 天花粉 桔梗 玄参 板蓝根 赤芍 蒲公英 马勃	麻疹 头痛 丹毒 瘰疬 痄腮 粉刺 皮肤瘙痒 口渴 牙痛 牙龈肿痛
角色0 ： 半夏 甘草 桔梗 橘红 前胡 茯苓 白矾 天南星 香附 山药  角色1 ： 橘红 瓜蒌 川贝母 半夏 法半夏 桔梗 化橘红 知母 天花粉 瓜蒌子  角色2 ： 枳壳 前胡 桔梗 半夏 甘草 知母 犀角 轻粉 附子 鱼腥草  角色3 ： 桔梗 枇杷 枇杷叶 薄荷 芦根 百部 橘红 桑 紫苏叶 青皮	咳嗽 胸闷 头晕 咽肿 手足厥冷 发狂 鼻干 阴疮 舌裂 心烦
角色0 ： 巴豆 甘遂 芫花 大戟 大黄 五灵脂 干漆 五倍子 千金子 草果  角色1 ： 木香 沉香 槟榔 青木香 吴茱萸 茯苓 郁金 大黄 乌梅 牛膝  角色2 ： 枳实 木香 厚朴 槟榔 大黄 半夏 吴茱萸 陈皮 枳壳 天门冬  角色3 ： 生姜 厚朴 木香 吴茱萸 槟榔 延胡索 乌梅 诃子 大黄 郁金	腹痛 腹满 反胃 噎膈 胃痛 身重 产后腹痛 短气 丹毒 痄腮
角色0 ： 五加 牛膝 五加皮 独活 薏苡仁 丹参 海桐皮 秦艽 当归 石斛  角色1 ： 防风 羌活 羚羊角 独活 酸枣仁 天麻 木瓜 牛膝 茯苓 细辛  角色2 ： 防风 羌活 独活 细辛 天麻 菊花 防己 牛膝 秦艽 木通  角色3 ： 防风 羌活 麻黄 羚羊角 菊花 独活 赤芍 苍术 蕤仁 白矾	目昏 项强 四肢拘急 恶风 四肢疼痛 头重 转筋 舌强 背痛 自汗
角色0 ： 丁香 木香 沉香 胡椒 荜茇 荜澄茄 母丁香 阿魏 诃子 茴香  角色1 ： 豆蔻 肉豆蔻 草豆蔻 高良姜 白豆蔻 荜澄茄 丁香 白附子 贯众 沙参  角色2 ： 豆蔻 肉豆蔻 砂仁 丁香 白豆蔻 木香 诃子 沉香 草果 橘红  角色3 ： 丁香 沉香 藿香 檀香 木香 甘松 零陵香 苏合香 降香 枳实	呕吐 恶心 肠鸣 吞酸 小儿呕吐 难产 呃逆 白内障 声音嘶哑 头昏
角色0 ： 葛根 石膏 升麻 柴胡 甘草 赤芍 寒水石 竹沥 羌活 荆芥  角色1 ： 石膏 麻黄 黄芩 葛根 柴胡 前胡 桔梗 雷丸 桑叶 麦门冬  角色2 ： 甘草 石膏 黄芩 葛根 滑石 羚羊角 麝香 旋覆花 川乌 寒水石  角色3 ： 葛根 麻黄 石膏 升麻 黄芩 葱白 桔梗 五味子 紫苏叶 旋覆花	头痛 壮热 鼻干 口臭 舌强 牙痛 臁疮 产后发热 浮肿 足颤
角色0 ： 细辛 藁本 川芎 蔓荆子 白芷 羌活 防风 荆芥 茯苓 甘松  角色1 ： 白芷 川芎 细辛 藁本 白术 藿香 贯众 陈皮 干姜 阿胶  角色2 ： 荆芥 川芎 白芷 羌活 细辛 防风 薄荷 石膏 苍术 天麻  角色3 ： 菊花 防风 薄荷 白芷 苍耳 苍耳子 辛夷 荆芥 野菊花 羌活	头痛 鼻塞 偏头痛 头晕 拳毛倒睫 漏睛 胸痛 壮热 阴痒 大便秘结
角色0 ： 茯苓 白术 泽泻 人参 山药 黄柏 苍术 荜澄茄 砂仁 五味子  角色1 ： 茯苓 白术 人参 甘草 泽泻 赤小豆 细辛 巴戟天 黄连 茵陈  角色2 ： 茯苓 白术 泽泻 陈皮 防己 附子 防风 白芍 橘红 山药  角色3 ： 泽泻 猪苓 木通 石膏 人参 茵陈 炙甘草 竹沥 防风 百草霜	小便不利 浮肿 身重 大便溏 臂痛 舌苔白 肥胖 产后浮肿 背痛 头昏
角色0 ： 琥珀 冰片 牛黄 珍珠 天竺黄 钩藤 胆南星 水牛角 珍珠母 朱砂  角色1 ： 朱砂 雄黄 麝香 牛黄 琥珀 天竺黄 牛胆 蛇蜕 安息香 铅丹  角色2 ： 牛黄 朱砂 钩藤 麝香 龙齿 犀角 蛇蜕 蜂房 天竺黄 白鲜皮  角色3 ： 麝香 朱砂 雄黄 牛黄 蟾酥 梅花 石菖蒲 丁香 犀角 五味子	痫 神昏 四肢抽搐 不寐 弄舌 耳内流脓 四肢拘急 恶寒发热 尿痛 鼻衄
角色0 ： 黄芩 柴胡 升麻 犀角 栀子 大黄 紫草 木通 木瓜 红花  角色1 ： 大黄 黄芩 黄连 黄柏 知母 柴胡 芍药 炮姜 蜂房 皂荚  角色2 ： 黄芩 栀子 大黄 黄连 郁金 麝香 黄柏 乌头 竹沥 人参  角色3 ： 栀子 茵陈 大黄 龙胆 升麻 茵陈蒿 枳实 黄芩 柴胡 贯众	壮热 发黄 头痛 舌苔黄 小便黄赤 头汗 弄舌 舌苔黄腻 黄汗 痫
角色0 ： 牡丹 牡丹皮 延胡索 白薇 生地黄 甘草 当归 芍药 乌药 泽泻  角色1 ： 当归 生地黄 蒲黄 阿胶 白芍 藕节 侧柏叶 小蓟 地骨皮 石斛  角色2 ： 芍药 赤芍 当归 甘草 升麻 肉桂 滑石 犀角 阿魏 鳖甲  角色3 ： 芍药 赤芍 甘草 肉桂 刘寄奴 红花 蒲黄 龙胆 鹿茸 猪牙皂	吐血 鼻衄 咳血 舌肿 大便下血 鼻塞 心悸 云雾移睛 面痛 漏下
