大黄 槟榔 牵牛 木香 牵牛子 防己 雷丸 使君子 青木香 鹤虱	咳嗽 腹痛 头痛 呕吐 小便不通 小便不利 壮热 痫 烦躁 气喘
甘草 当归 茯苓 人参 芍药 防风 白术 柴胡 附子 枳壳	四肢疼痛 四肢拘急 头重 咳嗽 胸痛 头痛 腰重 腹痛 腰脊痛 呕吐
巴豆 三棱 莪术 甘遂 五灵脂 芫花 轻粉 皂荚 巴豆霜 斑蝥	咳嗽 腹痛 呕吐 头痛 痫 壮热 恶心 气喘 小便不通 烦躁
甘草 茯苓 人参 白术 半夏 当归 防风 黄芩 陈皮 桔梗	目昏 气喘 小便不利 口渴 咳嗽 腹痛 头痛 上吐下泻 呕吐 咳痰
当归 防风 甘草 川芎 牛膝 羌活 附子 川乌 麻黄 独活	半身不遂 瘫痪 四肢麻木 骨痛 关节疼痛 咳嗽 腰膝无力 腹痛 足痛 头痛
车前 车前子 木通 滑石 猪苓 瞿麦 通草 泽泻 冬葵 石韦	咳嗽 腹痛 头痛 呕吐 烦躁 心烦 小便不通 壮热 口渴 小便不利
豆蔻 附子 肉豆蔻 干姜 丁香 木香 吴茱萸 高良姜 诃子 胡椒	腹痛 咳嗽 头痛 肠鸣 呕吐 盗汗 烦躁 转筋 腰痛 壮热
龙骨 牡蛎 赤石脂 硫黄 白矾 艾叶 地榆 禹余粮 石榴 紫石英	腹痛 咳嗽 头痛 呕吐 壮热 痫 心烦 崩中 烦躁 瘰疬
甘草 川芎 防风 黄芩 麻黄 白芷 石膏 羌活 茯苓 桔梗	头痛 鼻塞 无汗 咳嗽 腹痛 呕吐 心烦 壮热 目昏 烦躁
杏仁 杏 紫菀 款冬花 百合 百部 马兜铃 白前 蛤蚧 紫苏子	咳嗽 头痛 呕吐 腹痛 吐血 烦躁 壮热 恶心 浮肿 心烦
甘草 朱砂 人参 麝香 牛黄 附子 防风 天麻 黄芩 大黄	痫 神昏 咳嗽 腹痛 头痛 呕吐 烦躁 心烦 壮热 恶心
甘草 茯苓 人参 白术 半夏 陈皮 柴胡 当归 防风 黄芩	恶寒 口苦 身重 胸闷 恶寒发热 转筋 呃逆 咳嗽 腹痛 头痛
甘草 当归 连翘 大黄 白芷 防风 黄芩 赤芍 川芎 芍药	瘰疬 无名肿毒 丹毒 杨梅疮 臁疮 咳嗽 腹痛 胎毒 头痛 小儿丹毒
甘草 人参 黄芩 茯苓 麦门冬 柴胡 当归 芍药 桔梗 大黄	烦躁 咽干 咳嗽 头痛 腹痛 呕吐 心烦 壮热 痫 目昏
麝香 朱砂 雄黄 冰片 牛黄 蟾酥 硼砂 白矾 五倍子 珍珠	腹痛 头痛 呕吐 咳嗽 头晕 牙痛 恶心 壮热 胸闷 烦躁
黄连 胡黄连 郁李 郁李仁 芦荟 青黛 芜荑 使君子 龙胆 莲子	咳嗽 腹痛 头痛 呕吐 壮热 烦躁 心烦 潮热 痫 盗汗
甘草 黄芩 柴胡 人参 芍药 大黄 石膏 升麻 茯苓 麻黄	壮热 舌干 咳嗽 头痛 腹痛 呕吐 唇肿 烦躁 痫 恶心
甘草 桔梗 茯苓 半夏 人参 桑 麻黄 陈皮 五味子 黄芩	咳嗽 腹痛 头痛 呕吐 喉痒 妊娠咳嗽 痫 壮热 烦躁 心烦
甘草 黄芩 防风 大黄 当归 黄连 薄荷 荆芥 川芎 白芷	大便秘结 牙痛 流泪 皮肤瘙痒 咳嗽 头痛 舌肿 腹痛 喷嚏 牙龈肿痛
蒲黄 地榆 芥子 白芥 白芥子 阿胶 百草霜 槐花 三七 荷叶	咳嗽 腹痛 头痛 呕吐 心烦 烦躁 浮肿 恶心 瘰疬 痫
甘草 当归 附子 人参 防风 麻黄 茯苓 麝香 黄芩 羌活	角弓反张 舌强 咳嗽 头痛 咽喉痛 腹痛 足热 呕吐 心烦 头热
当归 甘草 茯苓 川芎 白芍 白术 人参 杜仲 牛膝 香附	腰痛 头晕 崩漏 不孕 头昏 畏寒 疲乏 咳嗽 须发早白 闭经
丁香 沉香 茴香 木香 益智 檀香 甘松 益智仁 樟脑 川楝子	腹痛 咳嗽 头痛 呕吐 壮热 气喘 烦躁 腰痛 目昏 浮肿
甘草 人参 当归 远志 茯苓 五味子 麦冬 酸枣仁 白芍 丹参	健忘 心悸 多梦 不寐 咳嗽 腹痛 头痛 呕吐 烦躁 壮热
甘草 木香 黄连 陈皮 槟榔 当归 茯苓 白术 厚朴 青皮	积滞 里急后重 疳积 口臭 大便溏 咳嗽 腹痛 头痛 呕吐 壮热
桑 枇杷 枇杷叶 竹茹 瓜蒌 川贝母 芦根 桑叶 橘红 葶苈子	咳嗽 头痛 呕吐 腹痛 烦躁 心烦 气喘 咽干 恶寒 壮热
甘草 人参 茯苓 白术 半夏 干姜 附子 木香 陈皮 当归	恶心 少气 手足厥冷 咳嗽 腹痛 头痛 呕吐 烦躁 痫 心下悸
藜 蒺藜 菊花 五加 苦参 五加皮 磁石 丹参 石决明 藜芦	头痛 咳嗽 腹痛 心烦 呕吐 头晕 烦躁 目昏 壮热 浮肿
牛膝 菟丝子 杜仲 肉苁蓉 五味子 山茱萸 远志 山药 枸杞子 鹿茸	盗汗 耳聋 目昏 咳嗽 小便频数 腹痛 头痛 腰膝无力 少气 呕吐
石膏 滑石 知母 甘草 寒水石 绿豆 荷叶 常山 青蒿 葛根	咳嗽 头痛 呕吐 腹痛 口渴 烦躁 壮热 心烦 恶寒 恶心
乳香 没药 麝香 血竭 轻粉 雄黄 冰片 朱砂 蓖麻 儿茶	瘰疬 无名肿毒 臁疮 咳嗽 腹痛 头痛 呕吐 杨梅疮 烦躁 壮热
茯苓 当归 甘草 白术 川芎 木香 人参 桑 陈皮 槟榔	浮肿 难产 噎膈 咳嗽 胞衣不下 寒战 产后腹痛 恶露不下 腹痛 头痛
甘草 当归 人参 白术 茯苓 川芎 芍药 白芍 柴胡 半夏	自汗 寒热往来 身痛 咳嗽 口淡 腹痛 头痛 呕吐 善怒 产后血崩
神曲 藿香 麦芽 香薷 山楂 木瓜 郁金 薄荷 白扁豆 砂仁	腹痛 头痛 咳嗽 呕吐 口渴 烦躁 头晕 心烦 潮热 壮热
甘草 茯苓 陈皮 半夏 木香 白术 人参 厚朴 当归 干姜	吞酸 腹满 胁痛 反胃 舌苔白 咳嗽 腹痛 头痛 呕吐 壮热
连翘 牛蒡 竹叶 牛蒡子 金银花 薄荷 淡竹 淡竹叶 玄参 荆芥	咳嗽 头痛 口渴 麻疹 恶寒 呕吐 腹痛 鼻塞 心烦 气喘
甘草 人参 茯苓 半夏 白术 干姜 生姜 当归 附子 麦门冬	短气 干呕 背痛 心下痞 咳嗽 多唾 头痛 腹痛 呕吐 小儿呕吐
当归 甘草 白术 人参 茯苓 木香 白芍 厚朴 川芎 芍药	腹痛 胎动不安 崩中 咳嗽 头痛 呕吐 经行腹痛 烦躁 壮热 恶寒
甘草 茯苓 陈皮 白术 木香 香附 砂仁 半夏 厚朴 山楂	嘈杂 嗳气 食欲不振 腹泻 胃痛 咳嗽 腹痛 头痛 呕吐 烦躁
麝香 朱砂 附子 全蝎 天麻 白附子 牛黄 僵蚕 甘草 天南星	慢惊 急惊 咳嗽 腹痛 头痛 呕吐 烦躁 痫 心烦 壮热
茵陈 栀子 大黄 甘草 黄芩 黄柏 黄连 茯苓 柴胡 枳实	发黄 咳嗽 头痛 腹痛 呕吐 心烦 舌苔黄 口渴 壮热 口苦
当归 甘草 白芍 白术 茯苓 人参 川芎 黄连 芍药 黄芩	五心烦热 便血 脱肛 胎漏 咳嗽 尿血 大便下血 臂痛 腹痛 呵欠
桃 桃仁 红花 大黄 蒲黄 延胡索 泽兰 苏木 水蛭 虻虫	腹痛 咳嗽 头痛 呕吐 心烦 腰痛 壮热 烦躁 痫 恶心
生姜 葱白 大枣 赤小豆 竹茹 菊花 小麦 鸡子 皂荚 苍耳	咳嗽 头痛 腹痛 呕吐 心烦 烦躁 壮热 恶寒 鼻塞 盗汗
杏 杏仁 苦杏仁 紫苏子 葶苈子 苦地丁 天竺黄 钩藤 苦瓜 蚕豆	咳嗽 头痛 呕吐 腹痛 鼻塞 壮热 烦躁 口渴 心烦 恶寒
麦冬 沙参 黄芪 丹参 天冬 何首乌 女贞 女贞子 梨 党参	咳嗽 口渴 头痛 腹痛 心烦 呕吐 咽干 盗汗 头晕 胸闷
乌梅 阿胶 生地黄 罂粟 罂粟壳 诃子 干姜 鹿角 大豆 鹿角胶	咳嗽 腹痛 头痛 呕吐 烦躁 吐血 心烦 浮肿 气喘 壮热
朱砂 牛黄 麝香 僵蚕 雄黄 天麻 天竺黄 全蝎 琥珀 钩藤	咳嗽 烦躁 呕吐 头痛 腹痛 气喘 潮热 目昏 心烦 口渴
甘草 防风 当归 附子 人参 麻黄 白术 茯苓 细辛 芍药	口噤 恶风 项强 耳聋 咳嗽 头痛 腹痛 呕吐 壮热 烦躁
甘草 人参 茯苓 当归 柴胡 白术 芍药 白芍 黄芩 知母	心烦 盗汗 潮热 消瘦 咳嗽 腹痛 头痛 呕吐 壮热 痫
甘草 黄芩 当归 茯苓 芍药 人参 赤芍 栀子 白芍 麦门冬	吐血 麻疹 小便不通 鼻衄 咳嗽 咳血 头痛 腹痛 呕吐 痄腮
甘草 黄芩 大黄 茯苓 人参 柴胡 知母 黄连 石膏 当归	谵语 发狂 鼻干 小便黄赤 咳嗽 腹痛 咽肿 头痛 呕吐 头汗
当归 白术 甘草 茯苓 白芍 川芎 香附 附子 人参 干姜	白带 赤白带 腹冷 漏下 面色青 咳嗽 头痛 腹痛 呕吐 烦躁
川乌 乌头 附子 天南星 白附子 草乌 天麻 麝香 地龙 白矾	头痛 咳嗽 腹痛 目昏 呕吐 壮热 腰痛 鼻塞 烦躁 皮肤瘙痒
甘草 茯苓 半夏 人参 白术 陈皮 木香 厚朴 干姜 丁香	呕吐 肠鸣 咳嗽 腹痛 头痛 壮热 烦躁 痫 白带 目昏
