甘草 茯苓 人参 当归 白术 川芎 干姜 木香 陈皮 附子	腹痛 里急后重 转筋 疳积 手足厥冷 面色青 脱肛 积滞 浮肿 上吐下泻
甘草 当归 茯苓 人参 黄芩 川芎 白术 芍药 陈皮 半夏	瘰疬 头痛 无名肿毒 臁疮 壮热 杨梅疮 牙痛 慢惊 疳积 骨痛
甘草 茯苓 当归 人参 白术 半夏 陈皮 木香 黄芩 附子	腹痛 腹满 呕吐 积滞 胁痛 胸闷 腹泻 身重 大便溏 舌苔白
甘草 茯苓 当归 人参 白术 川芎 陈皮 白芍 半夏 黄芩	盗汗 潮热 自汗 消瘦 目昏 小便频数 遗尿 耳聋 面色白 产后发热
甘草 当归 茯苓 人参 白术 川芎 陈皮 白芍 黄芩 半夏	头晕 健忘 心悸 头昏 食欲不振 胸闷 畏寒 多梦 疲乏 不寐
甘草 当归 茯苓 人参 白术 黄芩 川芎 白芍 半夏 桔梗	呕吐 腹痛 恶心 肠鸣 小便不利 远视 浮肿 小儿呕吐 近视 妊娠呕吐
甘草 人参 茯苓 当归 白术 陈皮 半夏 附子 黄芩 桔梗	咳嗽 气喘 鼻塞 头痛 咳痰 妊娠咳嗽 背冷 顿咳 皮肤甲错 胸痛
甘草 当归 茯苓 人参 黄芩 白术 芍药 川芎 白芍 陈皮	咳嗽 吐血 便血 鼻衄 咳血 尿血 大便下血 气喘 粉刺 湿疮
甘草 茯苓 人参 当归 白术 川芎 木香 芍药 附子 白芍	白带 赤白带 崩漏 腹冷 不孕 漏下 崩中 腰痛 恶露不下 闭经
甘草 当归 茯苓 人参 白术 芍药 附子 木香 陈皮 川芎	浮肿 腰痛 腹痛 胎动不安 难产 目昏 腰重 胎漏 胞衣不下 臂痛
甘草 茯苓 人参 当归 黄芩 白术 黄连 防风 川芎 桔梗	烦躁 神昏 麻疹 谵语 发狂 口渴 鼻干 咽喉痛 舌肿 呵欠
甘草 当归 茯苓 人参 白术 川芎 防风 附子 黄芩 半夏	半身不遂 目昏 瘫痪 四肢麻木 耳聋 骨痛 流泪 腰痛 腰膝无力 皮肤瘙痒
甘草 人参 当归 茯苓 白术 附子 黄芩 防风 芍药 半夏	短气 少气 项强 四肢疼痛 恶风 目昏 耳聋 背痛 四肢拘急 头重
甘草 茯苓 当归 人参 半夏 白术 黄芩 川芎 白芍 柴胡	头痛 恶寒 无汗 鼻塞 身痛 恶风 恶寒发热 身重 面痛 鼻翼煽动
甘草 当归 人参 白术 茯苓 附子 川芎 半夏 黄芩 木香	头痛 壮热 痫 鼻塞 寒战 面色红 舌干 脏躁 善太息 心烦
甘草 茯苓 当归 黄芩 人参 白术 柴胡 半夏 芍药 大黄	小便不利 小便不通 咳嗽 烦躁 干呕 丹毒 发黄 心下痞 胁痛 小便黄赤
甘草 茯苓 当归 人参 黄芩 半夏 桔梗 白术 大黄 防风	咳嗽 口渴 烦躁 大便秘结 咽干 口臭 舌干 牙痛 头痛 痄腮
甘草 茯苓 人参 当归 川芎 白术 防风 黄芩 半夏 芍药	痫 慢惊 口噤 急惊 角弓反张 神昏 舌强 项强 弄舌 言语错乱
甘草 人参 茯苓 当归 白术 柴胡 半夏 芍药 黄芩 白芍	心烦 口苦 舌干 咽干 寒热往来 五心烦热 潮热 头昏 盗汗 但热不寒
甘草 茯苓 当归 人参 白术 半夏 陈皮 川芎 大黄 黄芩	呕吐 恶心 吞酸 嘈杂 嗳气 反胃 噎膈 呃逆 胃痛 四肢抽搐
