角色0 ： 香附 川芎 当归 白芍 陈皮 熟地黄 甘草 附子 芍药 白术  角色1 ： 乌药 茯苓 砂仁 白术 人参 白芍 沉香 木香 甘草 川芎  角色2 ： 没药 乳香 当归 白芷 赤芍 芍药 川乌 骨碎补 细辛 牛膝  角色3 ： 防风 红花 僵蚕 白芷 连翘 大黄 乳香 金银花 甘草 羌活	白带 赤白带 腹痛 瘰疬 难产 无名肿毒 四肢疼痛 浮肿 头痛 臂痛
角色0 ： 牵牛 槟榔 木香 牵牛子 大黄 雷丸 三棱 青皮 萝卜 陈皮  角色1 ： 甘遂 巴豆 藜芦 芫花 附子 大戟 藜 泽泻 斑蝥 商陆  角色2 ： 巴豆 大黄 杏仁 杏 干姜 牛黄 麝香 当归 甘草 雄黄  角色3 ： 木香 青木香 沉香 升麻 甘草 麝香 丁香 连翘 大黄 犀角	腹满 小便不通 瘰疬 痫 腹痛 积滞 短气 口噤 小便不利 浮肿
角色0 ： 大黄 郁金 天竺黄 橘红 沉香 黄连 枳壳 甘草 茯苓 朱砂  角色1 ： 僵蚕 全蝎 天麻 钩藤 麝香 防风 牛黄 天竺黄 胆南星 朱砂  角色2 ： 牛黄 麝香 珍珠 琥珀 冰片 朱砂 雄黄 人参 硼砂 黄连  角色3 ： 半夏 白矾 天南星 巴豆 朱砂 轻粉 生姜 滑石 附子 白附子	痫 慢惊 急惊 咳嗽 烦躁 神昏 呕吐 气喘 目昏 头痛
角色0 ： 当归 川芎 白薇 茯苓 藁本 白术 没药 白芍 白芷 赤石脂  角色1 ： 附子 石斛 五味子 磁石 人参 牛膝 茯苓 木香 当归 续断  角色2 ： 细辛 柏子仁 干姜 甘草 当归 泽兰 防风 人参 厚朴 白术  角色3 ： 肉苁蓉 菟丝子 远志 杜仲 茯苓 牛膝 鹿茸 山茱萸 五味子 蛇床子	耳聋 少气 白带 短气 腰痛 盗汗 赤白带 腹痛 背痛 腰重
角色0 ： 荆芥 防风 桔梗 连翘 薄荷 黄芩 当归 甘草 大黄 栀子  角色1 ： 羌活 白芷 川芎 防风 甘草 苍术 细辛 桂枝 陈皮 香附  角色2 ： 芍药 当归 赤芍 黄芩 黄连 甘草 生地黄 升麻 黄柏 龙胆  角色3 ： 麻黄 石膏 甘草 白术 人参 知母 茯苓 前胡 干姜 地骨皮	头痛 恶寒 壮热 无汗 鼻塞 恶风 咳嗽 麻疹 恶寒发热 身痛
角色0 ： 桂枝 威灵仙 麻黄 牛膝 乳香 杜仲 独活 甘草 没药 羌活  角色1 ： 肉桂 当归 白芷 白术 茯苓 甘草 川芎 乌药 钩藤 木香  角色2 ： 秦艽 苍术 羌活 防己 黄柏 防风 枸杞子 桑 枳壳 陈皮  角色3 ： 牛膝 杜仲 木瓜 当归 独活 续断 防风 川芎 羌活 附子	腰痛 半身不遂 身痛 瘫痪 骨痛 转筋 四肢麻木 浮肿 关节疼痛 潮热
角色0 ： 大黄 木香 当归 黄连 槟榔 黄芩 枳壳 黄柏 甘草 青皮  角色1 ： 巴豆 木香 丁香 巴豆霜 朱砂 沉香 乳香 麝香 雄黄 乌梅  角色2 ： 三棱 莪术 香附 青皮 槟榔 山楂 大黄 牵牛 枳实 陈皮  角色3 ： 黄连 使君子 胡黄连 芜荑 芦荟 槟榔 龙胆 神曲 雷丸 青皮	腹痛 疳积 里急后重 积滞 大便秘结 潮热 消瘦 呕吐 恶心 噎膈
角色0 ： 麻黄 犀角 防风 麝香 羌活 牛黄 独活 当归 天麻 羚羊角  角色1 ： 天麻 全蝎 防风 人参 川芎 羌活 茯苓 甘草 独活 白术  角色2 ： 附子 白附子 僵蚕 天南星 麝香 朱砂 天麻 雄黄 半夏 牛黄  角色3 ： 僵蚕 蝉蜕 荆芥 桔梗 甘草 薄荷 黄芩 黄连 陈皮 枳壳	慢惊 痫 口噤 头痛 神昏 角弓反张 急惊 项强 舌强 半身不遂
角色0 ： 紫菀 款冬花 桑 甘草 百部 麻黄 白前 桔梗 前胡 射干  角色1 ： 麦门冬 茯苓 天门冬 百合 甘草 人参 柴胡 桔梗 知母 生地黄  角色2 ： 杏 杏仁 麻黄 甘草 防风 石膏 生姜 当归 芍药 桂枝  角色3 ： 五味子 人参 细辛 干姜 半夏 甘草 茯苓 白术 附子 生姜	咳嗽 短气 气喘 鼻塞 恶寒 吐血 无汗 呕吐 头痛 耳聋
角色0 ： 石膏 芍药 柴胡 黄芩 杏仁 杏 知母 升麻 甘草 赤芍  角色1 ： 葛根 甘草 升麻 生姜 人参 麻黄 茯苓 防风 白芍 枳壳  角色2 ： 藿香 防风 薄荷 白芷 羌活 半夏 川芎 陈皮 厚朴 甘草  角色3 ： 茵陈 大黄 栀子 黄芩 柴胡 枳实 甘草 秦艽 茵陈蒿 龙胆	壮热 头痛 发黄 恶寒 无汗 口渴 项强 心烦 麻疹 腹痛
角色0 ： 木香 柴胡 鳖甲 秦艽 人参 茯苓 牛膝 槟榔 枳壳 羌活  角色1 ： 白芍 柴胡 香附 青皮 甘草 当归 陈皮 黄芩 川芎 白术  角色2 ： 赤芍 当归 红花 芍药 川芎 延胡索 三棱 莪术 刘寄奴 肉桂  角色3 ： 牡丹 牡丹皮 生地黄 芍药 当归 甘草 干姜 黄连 桔梗 栀子	口苦 腹痛 胁痛 烦躁 心烦 舌干 吐血 五心烦热 潮热 寒热往来
角色0 ： 麦冬 当归 人参 天冬 五味子 远志 山药 丹参 玄参 茯苓  角色1 ： 五加 五加皮 牛膝 防风 当归 地骨皮 羌活 芍药 丹参 独活  角色2 ： 党参 黄芪 甘草 白术 陈皮 白芍 当归 茯苓 沙参 大枣  角色3 ： 女贞 女贞子 何首乌 桑 熟地黄 桑椹 菟丝子 黄精 制何首乌 枸杞子	头晕 心悸 健忘 盗汗 食欲不振 自汗 多梦 消瘦 头昏 疲乏
角色0 ： 黄柏 知母 当归 生地黄 白芍 川芎 五味子 芍药 麦门冬 人参  角色1 ： 泽泻 猪苓 茯苓 白术 甘草 苍术 陈皮 黄连 茵陈 厚朴  角色2 ： 车前 车前子 木通 黄芩 甘草 栀子 柴胡 龙胆 当归 滑石  角色3 ： 防风 菊花 决明子 细辛 青葙 青葙子 黄连 茺蔚子 菟丝子 枸杞子	小便不利 目昏 发黄 身重 小便不通 烦躁 小便黄赤 耳聋 口渴 潮热
角色0 ： 菊花 白芍 川芎 桑 天麻 牛膝 夏枯草 甘草 地龙 当归  角色1 ： 木贼 菊花 石决明 蝉蜕 甘草 荆芥 羌活 黄芩 防风 黄连  角色2 ： 藜 蒺藜 防风 茯苓 当归 甘草 附子 人参 枳壳 白术  角色3 ： 苦参 白芷 防风 苍耳 苍耳子 荆芥 威灵仙 何首乌 白鲜皮 苍术	目昏 流泪 头痛 皮肤瘙痒 麻疹 鼻塞 头晕 恶风 瘫痪 阴痒
角色0 ： 甘松 白芷 藿香 麝香 丁香 细辛 零陵香 沉香 香附 木香  角色1 ： 桂枝 僵蚕 白芷 青皮 川芎 当归 赤芍 附子 乌药 薄荷  角色2 ： 赭石 旋覆花 代赭石 甘草 杏仁 杏 薤白 瓜蒌 茯苓 丹参  角色3 ： 独活 麻黄 桃 香附 防风 白芷 荆芥 当归 羌活 乌药	鼻衄 口臭 舌苔白 呕吐 粉刺 呃逆 口苦 鼻塞 大便下血 白带
角色0 ： 牛蒡 连翘 牛蒡子 薄荷 荆芥 甘草 金银花 桔梗 竹叶 桑  角色1 ： 冰片 大青叶 金银花 板蓝根 牛黄 赤芍 甘草 水牛角 羚羊角 羌活  角色2 ： 天花粉 玄参 桔梗 麦冬 甘草 陈皮 黄芩 知母 山豆根 茯苓  角色3 ： 连翘 薄荷 黄芩 栀子 石膏 黄连 大黄 甘草 桔梗 黄柏	咳嗽 口渴 头痛 麻疹 恶寒 咽干 大便秘结 鼻塞 壮热 丹毒
角色0 ： 干姜 川芎 桔梗 白芷 陈皮 厚朴 当归 枳壳 甘草 苍术  角色1 ： 茴香 小茴香 川楝子 当归 木香 附子 香附 吴茱萸 川芎 甘草  角色2 ： 三棱 莪术 青皮 木香 陈皮 槟榔 神曲 枳壳 甘草 半夏  角色3 ： 香附 砂仁 木香 乌药 沉香 姜黄 甘草 丁香 豆蔻 厚朴	腹痛 呕吐 恶心 吞酸 嘈杂 胃痛 腰痛 干呕 嗳气 胁痛
角色0 ： 石菖蒲 远志 酸枣仁 人参 琥珀 茯苓 当归 甘草 朱砂 龙齿  角色1 ： 麝香 丁香 朱砂 雄黄 沉香 木香 檀香 冰片 苍术 大戟  角色2 ： 珍珠 郁金 牛黄 黄芩 黄连 栀子 冰片 朱砂 珍珠母 甘草  角色3 ： 乳香 地龙 没药 乌头 五灵脂 川乌 天麻 草乌 附子 防风	痫 神昏 头晕 头痛 瘫痪 腹痛 耳聋 烦躁 健忘 心烦
角色0 ： 白芍 生地黄 甘草 川芎 当归 茯苓 白术 陈皮 熟地黄 酸枣仁  角色1 ： 大枣 生姜 甘草 桂枝 芍药 半夏 黄芩 人参 麻黄 柴胡  角色2 ： 桃 桃仁 红花 当归 川芎 赤芍 甘草 香附 泽兰 大黄  角色3 ： 麦门冬 人参 茯苓 甘草 当归 远志 五味子 白术 芍药 泽泻	恶寒 少气 腹痛 短气 心烦 头痛 吐血 自汗 腹满 咳嗽
角色0 ： 附子 木香 茴香 牛膝 巴戟天 肉苁蓉 沉香 羌活 槟榔 安息香  角色1 ： 当归 大黄 芍药 牡丹 赤芍 琥珀 牛膝 蒲黄 水蛭 虻虫  角色2 ： 三棱 干漆 芫花 没药 五灵脂 莪术 大黄 木香 巴豆 当归  角色3 ： 桃 桃仁 柴胡 甘草 茯苓 槟榔 人参 鳖甲 杏仁 杏	腹痛 恶露不下 腰痛 四肢疼痛 大便秘结 腹满 胸痛 舌干 浮肿 口苦
角色0 ： 桔梗 半夏 橘红 瓜蒌 黄芩 甘草 法半夏 枳壳 杏 茯苓  角色1 ： 茯苓 白术 山药 甘草 人参 党参 白扁豆 砂仁 芡实 莲子  角色2 ： 枳实 黄连 半夏 茯苓 陈皮 白术 香附 甘草 栀子 黄芩  角色3 ： 神曲 山楂 麦芽 厚朴 木香 苍术 砂仁 陈皮 青皮 香附	呕吐 嘈杂 吞酸 恶心 腹痛 嗳气 积滞 咳嗽 食欲不振 腹满
角色0 ： 苦杏仁 紫苏子 杏 麻黄 杏仁 川贝母 石膏 半夏 法半夏 甘草  角色1 ： 橘红 瓜蒌 杏仁 杏 甘草 桔梗 薄荷 川贝母 麦冬 化橘红  角色2 ： 款冬花 杏 杏仁 五味子 知母 紫菀 甘草 桑 阿胶 半夏  角色3 ： 芥子 白芥 白芥子 茯苓 当归 白术 柴胡 甘草 白芍 麦冬	咳嗽 气喘 咽干 浮肿 胸闷 胁痛 咳血 舌干 口苦 大便秘结
角色0 ： 羌活 防风 独活 柴胡 甘草 川芎 黄芩 苍术 厚朴 白芷  角色1 ： 枳壳 桔梗 茯苓 前胡 半夏 甘草 陈皮 人参 生姜 木香  角色2 ： 升麻 柴胡 当归 甘草 炙甘草 黄柏 苍术 人参 黄连 白术  角色3 ： 细辛 川芎 荆芥 薄荷 白芷 蔓荆子 藁本 防风 甘草 石膏	头痛 鼻塞 恶风 咳嗽 恶寒 目昏 无汗 项强 壮热 牙痛
角色0 ： 鹿角 鹿角胶 枸杞子 熟地黄 当归 鹿角霜 锁阳 黄芪 白术 山药  角色1 ： 茯苓 菟丝子 远志 枸杞子 五味子 山药 牛膝 覆盆子 杜仲 当归  角色2 ： 牡蛎 龙骨 桑 桑螵蛸 芡实 茯苓 莲须 山药 杜仲 白芍  角色3 ： 鹿茸 肉苁蓉 补骨脂 茴香 菟丝子 附子 牛膝 沉香 杜仲 小茴香	腰痛 头晕 盗汗 白带 小便频数 目昏 健忘 遗尿 自汗 不孕
角色0 ： 全蝎 蜈蚣 麝香 五灵脂 朱砂 雄黄 僵蚕 穿山甲 斑蝥 草乌  角色1 ： 丁香 远志 龙骨 牛膝 蛇床子 赤石脂 甘草 鹿茸 木香 菟丝子  角色2 ： 麝香 黄连 胡黄连 芦荟 青黛 朱砂 熊胆 雄黄 牛黄 丁香  角色3 ： 乳香 没药 麝香 血竭 冰片 雄黄 朱砂 牛黄 蟾酥 沉香	慢惊 壮热 无名肿毒 瘰疬 痫 腹痛 神昏 急惊 赤白带 白带
角色0 ： 杜仲 白术 续断 白芍 当归 阿胶 甘草 川芎 砂仁 党参  角色1 ： 桑 桑寄生 当归 人参 甘草 桑枝 独活 茯苓 狗脊 牛膝  角色2 ： 益母草 香附 当归 延胡索 木香 丹参 川芎 肉桂 白芍 红花  角色3 ： 丹参 三七 赤芍 黄芪 牛膝 红花 川芎 地龙 桃 鸡血藤	腹痛 胎动不安 腰痛 胸闷 难产 白带 五心烦热 胎漏 赤白带 崩漏
角色0 ： 麦冬 甘草 白芍 知母 石斛 当归 茯苓 黄芩 人参 地骨皮  角色1 ： 青蒿 香附 陈皮 半夏 黄芩 车前 厚朴 泽泻 荆芥 木通  角色2 ： 沙参 天冬 桑 百合 桔梗 百部 北沙参 杏 杏仁 桑叶  角色3 ： 枇杷 枇杷叶 甘草 人参 半夏 枳壳 麦门冬 茯苓 前胡 桔梗	咳嗽 口渴 咽干 心烦 吐血 烦躁 呕吐 潮热 头痛 舌干
角色0 ： 石膏 甘草 滑石 大黄 黄芩 寒水石 人参 牡蛎 麻黄 赤石脂  角色1 ： 牛蒡 牛蒡子 木通 防风 荆芥 连翘 桔梗 甘草 紫草 升麻  角色2 ： 赤芍 芍药 黄芩 柴胡 甘草 麦门冬 茯苓 前胡 枳实 知母  角色3 ： 大黄 犀角 升麻 玄参 枳壳 甘草 栀子 连翘 木通 黄芩	壮热 烦躁 瘰疬 谵语 麻疹 头痛 丹毒 心烦 舌干 舌肿
角色0 ： 白术 茯苓 人参 陈皮 甘草 蓼蓝 荆芥 忍冬藤 肉桂 蛇蜕  角色1 ： 柴胡 甘草 黄芩 半夏 人参 栀子 生姜 厚朴 草果 龙胆  角色2 ： 柴胡 鳖甲 地骨皮 知母 人参 秦艽 芍药 桔梗 枳壳 茯苓  角色3 ： 当归 白芍 川芎 芍药 甘草 熟地黄 五味子 忍冬藤 鲜地黄 附子	潮热 盗汗 咳嗽 寒热往来 自汗 头痛 胁痛 五心烦热 口苦 心烦
角色0 ： 木香 沉香 豆蔻 红花 丁香 檀香 肉豆蔻 诃子 肉桂 川楝子  角色1 ： 神曲 朱砂 琥珀 麦芽 山楂 钩藤 薄荷 天竺黄 陈皮 槟榔  角色2 ： 益智 益智仁 甘草 人参 茯苓 香附 远志 砂仁 陈皮 白术  角色3 ： 滑石 瞿麦 木通 车前 冬葵 甘草 冬葵子 车前子 茯苓 黄芩	小便不通 小便不利 舌干 难产 遗尿 腹痛 小便频数 呕吐 咳嗽 阴疮
角色0 ： 茯苓 大黄 甘草 芍药 防风 当归 人参 远志 杏仁 干姜  角色1 ： 青黛 薄荷 硼砂 甘草 冰片 黄连 玄明粉 寒水石 荷叶 滑石  角色2 ： 龙齿 钩藤 升麻 犀角 人参 石膏 麦门冬 防风 远志 蛇蜕  角色3 ： 牛黄 朱砂 麝香 雄黄 天竺黄 甘草 犀角 人参 天麻 天南星	痫 壮热 烦躁 神昏 心烦 咳嗽 发狂 丹毒 鼻干 舌肿
角色0 ： 葱白 生姜 甘草 陈皮 黄芩 当归 防风 枳壳 桑 白芍  角色1 ： 夏枯草 昆布 海藻 当归 连翘 桔梗 甘草 牡蛎 柴胡 青皮  角色2 ： 乌梅 甘草 常山 鳖甲 人参 柴胡 知母 大黄 石膏 薤白  角色3 ： 金银花 茯苓 当归 土茯苓 防风 甘草 白鲜皮 川芎 木通 木瓜	瘰疬 杨梅疮 头痛 恶寒 寒热往来 腹痛 壮热 烦躁 便血 但热不寒
角色0 ： 牡蛎 麻黄 当归 人参 甘草 白术 麻黄根 柴胡 茯苓 小麦  角色1 ： 独活 防风 防己 麻黄 甘草 人参 附子 黄芩 秦艽 细辛  角色2 ： 防风 细辛 山茱萸 附子 干姜 牛膝 乌头 独活 石斛 秦艽  角色3 ： 羚羊角 防风 枳壳 菊花 甘草 酸枣仁 羌活 麦门冬 芍药 茯苓	口噤 盗汗 头痛 项强 恶风 目昏 四肢拘急 自汗 耳聋 角弓反张
角色0 ： 肉桂 人参 附子 白术 甘草 茯苓 干姜 炮姜 当归 半夏  角色1 ： 远志 人参 五味子 柏子仁 麦门冬 茯苓 酸枣仁 天门冬 熟地黄 甘草  角色2 ： 山药 茯苓 泽泻 山茱萸 牡丹皮 牡丹 熟地黄 麦冬 五味子 枸杞子  角色3 ： 炙甘草 当归 白芍 甘草 白术 川芎 人参 杜仲 陈皮 茯苓	健忘 盗汗 自汗 腹痛 短气 畏寒 咳嗽 头晕 心悸 心烦
角色0 ： 草乌 川芎 川乌 细辛 防风 天麻 白芷 麻黄 甘草 苍术  角色1 ： 乌头 川乌 附子 天南星 半夏 白附子 干姜 藿香 白芷 僵蚕  角色2 ： 牛膝 当归 独活 红花 木瓜 秦艽 五加皮 五加 羌活 川乌  角色3 ： 牵牛 皂荚 猪牙皂 麝香 大黄 薄荷 牵牛子 半夏 何首乌 赤小豆	头痛 半身不遂 瘰疬 四肢麻木 瘫痪 恶心 牙痛 口噤 鼻塞 角弓反张
角色0 ： 诃子 甘草 罂粟 罂粟壳 人参 茯苓 白术 木香 陈皮 当归  角色1 ： 桔梗 人参 紫菀 干姜 吴茱萸 茯苓 厚朴 川乌 柴胡 巴豆  角色2 ： 郁李 郁李仁 槟榔 桑 牵牛 茯苓 枳壳 牵牛子 大黄 木香  角色3 ： 豆蔻 肉豆蔻 木香 附子 黄连 干姜 赤石脂 吴茱萸 当归 龙骨	浮肿 肠鸣 腹痛 里急后重 气喘 小便不利 脱肛 咳嗽 呕吐 反胃
角色0 ： 丁香 砂仁 茴香 甘草 木香 藿香 细辛 陈皮 肉桂 香附  角色1 ： 胡椒 荜茇 丁香 阿魏 干姜 附子 木香 高良姜 肉桂 人参  角色2 ： 硫黄 附子 吴茱萸 干姜 朱砂 白矾 丁香 麝香 阳起石 雄黄  角色3 ： 樟脑 冰片 薄荷 白芷 川乌 独活 当归 乳香 麝香 草乌	恶心 腹痛 呕吐 骨痛 手足厥冷 腹冷 面色青 赤白带 白带 转筋
角色0 ： 茯苓 大腹皮 槟榔 木通 桑 防己 木香 泽泻 大黄 猪苓  角色1 ： 前胡 半夏 旋覆花 枳壳 甘草 茯苓 防风 芍药 赤芍 石膏  角色2 ： 杏 杏仁 桔梗 甘草 麻黄 黄芩 陈皮 枳壳 苦杏仁 前胡  角色3 ： 桑 桑白皮 甘草 人参 茯苓 地骨皮 五味子 桔梗 当归 知母	咳嗽 浮肿 气喘 小便不利 头痛 鼻塞 目昏 恶寒 鼻干 呕吐
角色0 ： 竹茹 甘草 人参 半夏 麦门冬 茯苓 生姜 芦根 淡竹 枳实  角色1 ： 车前 车前子 茯苓 白术 陈皮 苍术 甘草 白芍 黄柏 柴胡  角色2 ： 冬瓜 大黄 泽泻 茵陈 蒲公英 丹参 金银花 黄芪 白术 茯苓  角色3 ： 藿香 木通 杏 杏仁 泽泻 半夏 厚朴 枳壳 陈皮 甘草	干呕 鼻衄 吐血 呕吐 舌苔黄 烦躁 浮肿 咳嗽 肥胖 胸闷
角色0 ： 生姜 豆蔻 草豆蔻 厚朴 高良姜 甘草 白术 干姜 附子 吴茱萸  角色1 ： 陈皮 砂仁 神曲 青皮 干姜 甘草 厚朴 木香 草果 半夏  角色2 ： 豆蔻 肉豆蔻 白豆蔻 沉香 木香 丁香 槟榔 附子 荜澄茄 三棱  角色3 ： 人参 丁香 白术 茯苓 藿香 甘草 木香 半夏 橘红 柿蒂	呕吐 恶心 腹痛 肠鸣 吞酸 呃逆 腹满 转筋 反胃 腹冷
角色0 ： 厚朴 陈皮 苍术 甘草 藿香 砂仁 香附 白芍 炙甘草 黄芩  角色1 ： 藿香 茯苓 甘草 香薷 木瓜 白芷 广藿香 厚朴 桔梗 紫苏叶  角色2 ： 木香 槟榔 枳壳 青皮 大腹皮 草果 陈皮 木通 甘草 木瓜  角色3 ： 半夏 白术 茯苓 人参 甘草 生姜 橘红 附子 竹沥 木香	呕吐 腹痛 恶心 头痛 浮肿 转筋 咳嗽 身重 恶寒 反胃
角色0 ： 附子 干姜 白术 甘草 人参 茯苓 桂枝 川芎 猪胆汁 地锦草  角色1 ： 细辛 吴茱萸 干姜 当归 桔梗 茯苓 甘草 防风 黄芩 人参  角色2 ： 芍药 半夏 当归 甘草 人参 茯苓 前胡 赤芍 白芍 橘红  角色3 ： 厚朴 生姜 木香 槟榔 大黄 白术 枳壳 人参 枳实 茯苓	腹痛 呕吐 头痛 恶寒 腹满 短气 背痛 手足厥冷 小便不利 干呕
角色0 ： 阿胶 当归 艾叶 芍药 甘草 白芍 川芎 人参 续断 白术  角色1 ： 蒲黄 甘草 白芍 侧柏叶 小蓟 生地黄 黄芩 茜草 藕节 荷叶  角色2 ： 地榆 黄连 当归 黄芩 黄柏 甘草 槐花 枳壳 乌梅 木香  角色3 ： 龙骨 干姜 赤石脂 当归 禹余粮 牡蛎 附子 白芷 桑 厚朴	吐血 腹痛 便血 崩中 漏下 白带 崩漏 赤白带 尿血 心烦
角色0 ： 升麻 犀角 甘草 柴胡 玄参 龙胆 木通 羚羊角 桔梗 射干  角色1 ： 竹叶 淡竹 淡竹叶 甘草 连翘 生地黄 木通 麦冬 滑石 通草  角色2 ： 麦门冬 石膏 知母 甘草 人参 茯苓 地骨皮 葛根 前胡 芦根  角色3 ： 黄芩 栀子 黄连 大黄 甘草 黄柏 郁金 苦参 秦艽 黄药子	烦躁 壮热 头痛 心烦 口渴 舌干 发狂 谵语 咽干 麻疹
角色0 ： 甘草 川芎 黄芩 杏 杏仁 桔梗 白芍 当归 牛黄 柴胡  角色1 ： 白及 当归 大黄 白芷 草乌 五倍子 黄柏 木鳖子 黄连 穿山甲  角色2 ： 乳香 没药 轻粉 血竭 麝香 雄黄 儿茶 龙骨 冰片 松香  角色3 ： 杏 杏仁 蓖麻 蓖麻子 白芷 巴豆 桃 白蔹 当归 桃仁	臁疮 瘰疬 无名肿毒 杨梅疮 湿疮 耳聋 阴疮 吐血 咳嗽 白带
