牛膝 桃 杜仲 当归 桃仁 附子 菟丝子 续断 五味子 肉苁蓉	腰痛 耳聋 目昏 小便频数 不孕 少气 头昏 腹冷 腰膝无力 骨痛
半夏 茯苓 甘草 人参 枳壳 生姜 白术 陈皮 前胡 桔梗	呕吐 咳嗽 干呕 恶心 目昏 心下痞 呃逆 胁痛 短气 多唾
茯苓 大黄 木通 泽泻 槟榔 滑石 车前 车前子 枳壳 牵牛	浮肿 小便不利 小便不通 腹满 气喘 尿血 难产 妊娠小便不通 产后浮肿 黄汗
甘草 连翘 桔梗 黄芩 玄参 薄荷 麦冬 荆芥 牛蒡 石膏	口渴 烦躁 麻疹 谵语 咽干 丹毒 舌干 发狂 神昏 大便秘结
甘草 芍药 石膏 黄芩 升麻 赤芍 柴胡 葛根 麦门冬 犀角	头痛 壮热 烦躁 鼻干 口渴 小儿丹毒 口中生疮 小儿口疮 头重 发癍
乳香 没药 麝香 川乌 轻粉 白芷 雄黄 草乌 乌头 冰片	瘰疬 臁疮 无名肿毒 牙痛 瘫痪 杨梅疮 半身不遂 湿疮 胎毒 骨痛
当归 白术 牛膝 人参 甘草 肉桂 附子 川芎 桃 木香	腹痛 脱肛 胁痛 难产 骨痛 头昏 舌苔白 口苦 少腹痛 胸闷
远志 茯苓 山药 人参 麦冬 牡蛎 五味子 丹参 龙骨 党参	盗汗 头晕 心悸 健忘 自汗 胸闷 遗尿 多梦 食欲不振 心烦
甘草 柴胡 人参 麦门冬 茯苓 知母 地骨皮 鳖甲 芍药 枳壳	心烦 潮热 口苦 盗汗 舌干 寒热往来 五心烦热 咽干 烦躁 四肢疼痛
干姜 白术 人参 生姜 附子 甘草 厚朴 吴茱萸 当归 茯苓	腹痛 短气 转筋 腹满 少气 手足厥冷 面色青 肠鸣 背痛 腹冷
当归 白芍 川芎 芍药 阿胶 香附 牡丹 牡丹皮 赤芍 艾叶	白带 腹痛 赤白带 崩漏 胎动不安 崩中 漏下 胎漏 胞衣不下 吐血
防风 川芎 白芷 细辛 荆芥 羌活 甘草 薄荷 菊花 藜	头痛 鼻塞 目昏 流泪 皮肤瘙痒 牙痛 头昏 偏头痛 胬肉攀睛 拳毛倒睫
陈皮 厚朴 香附 神曲 苍术 半夏 砂仁 青皮 藿香 山楂	呕吐 恶心 吞酸 腹痛 嘈杂 嗳气 反胃 积滞 噎膈 腹泻
黄连 黄芩 大黄 黄柏 栀子 甘草 龙胆 胡黄连 芦荟 青黛	烦躁 壮热 心烦 发黄 疳积 便血 里急后重 口臭 大便秘结 大便下血
杏 杏仁 桑 桔梗 麻黄 紫菀 甘草 桑白皮 五味子 款冬花	咳嗽 气喘 咳痰 喉痒 妊娠咳嗽 鼻塞 面色白 短气 腰脊痛 无汗
朱砂 麝香 牛黄 僵蚕 天麻 附子 白附子 全蝎 雄黄 天南星	痫 慢惊 神昏 急惊 口噤 角弓反张 四肢抽搐 小儿发热 舌强 弄舌
防风 麻黄 独活 羌活 当归 甘草 细辛 川芎 附子 秦艽	无汗 口噤 头痛 恶风 项强 半身不遂 恶寒 角弓反张 四肢拘急 四肢麻木
木香 丁香 豆蔻 沉香 槟榔 三棱 肉豆蔻 莪术 青皮 茴香	腹痛 呕吐 恶心 肠鸣 积滞 吞酸 里急后重 腹冷 反胃 口苦
桔梗 甘草 麦冬 黄芩 枇杷 枇杷叶 荷叶 瓜蒌 茯苓 沙参	吐血 咳嗽 鼻衄 便血 胸闷 咽干 咳血 口渴 舌苔黄 气喘
甘草 白术 人参 茯苓 当归 白芍 陈皮 炙甘草 肉桂 川芎	恶寒 自汗 身重 恶寒发热 消瘦 畏寒 潮热 头重 恶风 胁痛
