角色0 ： 黄芩 栀子 大黄 黄连 黄柏 寒水石 川芎 黄药子 柴胡 羚羊角  角色1 ： 大黄 芥子 枳实 白芥 柴胡 白芥子 茯苓 郁金 莱菔子 附子  角色2 ： 茵陈 栀子 黄芩 大黄 龙胆 黄柏 茵陈蒿 薤白 桂枝 大腹皮  角色3 ： 黄连 大黄 黄柏 黄芩 郁金 栀子 绿豆 生姜 川乌 木瓜	谵语 大便秘结 发黄 发狂 烦躁 舌苔黄 小便黄赤 麻疹 肥胖 胁痛
角色0 ： 丁香 胡椒 木香 沉香 荜茇 肉桂 高良姜 阿魏 茴香 荜澄茄  角色1 ： 豆蔻 丁香 木香 肉豆蔻 白豆蔻 砂仁 荜澄茄 沉香 当归 槟榔  角色2 ： 木香 丁香 沉香 母丁香 檀香 姜黄 附子 生姜 郁金 白矾  角色3 ： 豆蔻 肉豆蔻 草豆蔻 诃子 白豆蔻 高良姜 砂仁 槟榔 厚朴 萝卜	肠鸣 呕吐 恶心 腹痛 吞酸 积滞 食欲不振 脱肛 足颤 胸闷
角色0 ： 石膏 升麻 知母 葛根 黄芩 柴胡 黄连 寒水石 乌药 海螵蛸  角色1 ： 石膏 葛根 升麻 赤芍 知母 栀子 柴胡 黄芩 羚羊角 玄参  角色2 ： 竹叶 淡竹 淡竹叶 麦门冬 竹茹 芦根 连翘 芍药 甘草 木通  角色3 ： 甘草 黄芩 石膏 麻黄 葛根 前胡 百合 绿豆 地骨皮 白果	头痛 壮热 大便下血 唇肿 烦躁 少气 头昏 胸闷 头晕 身重
角色0 ： 木香 黄连 青皮 槟榔 大黄 芍药 白术 三七 郁金 白芍  角色1 ： 槟榔 木香 黄连 枳壳 炙甘草 青木香 藿香 前胡 砂仁 泽兰  角色2 ： 木香 槟榔 大黄 枳壳 青皮 青木香 鸡内金 苦楝皮 砂仁 桂枝  角色3 ： 胡黄连 黄连 芦荟 使君子 芜荑 龙胆 青黛 雷丸 鹤虱 熊胆	腹痛 疳积 消瘦 里急后重 口臭 积滞 脱肛 鼻痒 不孕 口中生疮
角色0 ： 枇杷 枇杷叶 桔梗 薄荷 甘草 芦根 前胡 竹茹 梨 百部  角色1 ： 桔梗 枳壳 前胡 橘红 黄芩 生姜 白茅根 萝卜 杏 栀子  角色2 ： 半夏 橘红 瓜蒌 川贝母 法半夏 化橘红 石膏 紫苏子 瓜蒌子 麻黄  角色3 ： 甘草 桔梗 茯苓 枳壳 半夏 紫苏叶 槟榔 枳实 厚朴 瓜蒌	咳嗽 干呕 胸闷 咳痰 四肢疼痛 鼻塞 胃痛 阴痒 臂痛 目昏
角色0 ： 细辛 川芎 白芷 藁本 蔓荆子 白薇 旋覆花 当归 白芍 地骨皮  角色1 ： 防风 白芷 羌活 薄荷 川芎 天麻 荆芥 独活 当归 益母草  角色2 ： 细辛 白芷 川芎 藁本 独活 荆芥 防风 乌药 薄荷 当归  角色3 ： 川芎 防风 荆芥 白芷 苍术 羌活 薄荷 麻黄 桑枝 旋覆花	头痛 鼻塞 头昏 偏头痛 目昏 项强 口渴 口臭 积滞 四肢疼痛
角色0 ： 防风 羌活 独活 细辛 川芎 荆芥 桔梗 肉桂 陈皮 冬瓜  角色1 ： 川芎 羌活 白芷 防风 苍术 细辛 葛根 炙甘草 独活 香附  角色2 ： 苍术 防风 白芷 麻黄 羌活 桔梗 当归 厚朴 铅丹 乌梅  角色3 ： 防风 川芎 羌活 荆芥 苍术 桂枝 五味子 防己 远志 甘草	恶寒 头痛 无汗 身痛 恶寒发热 针眼 神昏 瘫痪 低热 牙龈溃烂
角色0 ： 益智 人参 益智仁 远志 茯苓 五味子 石菖蒲 橘红 枸杞子 肉桂  角色1 ： 牡蛎 龙骨 五味子 麻黄根 小麦 茯苓 泽泻 桑螵蛸 浮小麦 莲须  角色2 ： 白术 茯苓 肉桂 人参 山药 安息香 石膏 麝香 葱白 芦根  角色3 ： 山药 泽泻 芡实 山茱萸 莲子 白扁豆 薏苡仁 莲须 柏子仁 莲子心	盗汗 自汗 遗尿 小便频数 畏寒 头晕 小儿遗尿 心悸 脏躁 小儿厌食
角色0 ： 乌头 川乌 细辛 草乌 干姜 苍术 两头尖 花椒 巴豆 秦艽  角色1 ： 防风 麻黄 独活 羚羊角 羌活 秦艽 石膏 梨 柴胡 黄连  角色2 ： 附子 天南星 白附子 天麻 僵蚕 防风 硫黄 荆芥 冬瓜 花椒  角色3 ： 防风 附子 独活 秦艽 防己 细辛 麻黄 竹沥 人参 巴豆	口噤 半身不遂 项强 角弓反张 四肢拘急 舌强 四肢强直 浮肿 背痛 自汗
角色0 ： 半夏 陈皮 茯苓 白术 甘草 当归 炙甘草 郁金 厚朴 乌梅  角色1 ： 人参 白术 茯苓 半夏 甘草 巴豆 草果 附子 砂仁 天麻  角色2 ： 甘草 陈皮 半夏 茯苓 人参 白术 乌梅 黄芩 木瓜 山药  角色3 ： 白术 茯苓 甘草 人参 陈皮 生姜 防风 神曲 茵陈 橘红	呕吐 腹满 恶心 大便溏 胁痛 头昏 头痛 臂痛 寒战 脱肛
角色0 ： 茯苓 白术 人参 当归 甘草 绿豆 细辛 肉桂 干姜 远志  角色1 ： 白术 茯苓 人参 苍术 半夏 木香 乌梅 麦门冬 当归 龙骨  角色2 ： 甘草 人参 陈皮 半夏 炙甘草 茯苓 柴胡 巴豆 防己 瓜蒌  角色3 ： 甘草 白术 当归 茯苓 炙甘草 柴胡 陈皮 益智 海螵蛸 鸡子	自汗 短气 身重 恶风 头重 小便黄赤 口淡 言语错乱 头晕 恶寒
角色0 ： 柴胡 知母 地骨皮 鳖甲 秦艽 紫菀 赤芍 银柴胡 生姜 甘草  角色1 ： 鳖甲 地骨皮 柴胡 秦艽 青蒿 知母 常山 乌梅 姜黄 甘草  角色2 ： 柴胡 甘草 地骨皮 知母 茯苓 枳壳 白术 鳖甲 黄芩 远志  角色3 ： 甘草 人参 茯苓 柴胡 白术 麻黄 知母 黄芩 升麻 秦艽	潮热 盗汗 寒热往来 消瘦 但热不寒 谵语 口苦 头晕 少气 舌卷
角色0 ： 大黄 黄柏 黄芩 黄连 寒水石 皂角刺 红花 斑蝥 槐角 芦根  角色1 ： 白芷 连翘 白及 白蔹 夏枯草 昆布 海藻 玄参 五倍子 升麻  角色2 ： 升麻 玄参 犀角 射干 连翘 黄芩 漏芦 枳实 附子 马蔺  角色3 ： 白矾 大黄 皂荚 猪牙皂 巴豆 斑蝥 黄连 苦参 玄参 熟地黄	瘰疬 牙痛 咽喉痛 舌肿 粉刺 腹满 丹毒 舌干 耳痛 胞衣不下
角色0 ： 乳香 没药 血竭 轻粉 儿茶 象皮 阿魏 穿山甲 藤黄 三七  角色1 ： 麝香 雄黄 朱砂 冰片 蟾酥 琥珀 牛黄 珍珠 安息香 水牛角  角色2 ： 乳香 轻粉 没药 穿山甲 蓖麻 松香 蓖麻子 樟脑 木鳖子 白芷  角色3 ： 冰片 硼砂 麝香 青黛 珍珠 雄黄 儿茶 炉甘石 熊胆 海螵蛸	臁疮 无名肿毒 瘰疬 牙痛 杨梅疮 湿疮 流泪 舌肿 阴疮 胎毒
角色0 ： 生地黄 当归 白芍 熟地黄 芍药 黄连 黄柏 升麻 竹沥 冬瓜  角色1 ： 芍药 赤芍 当归 三七 柴胡 藿香 人参 延胡索 石膏 巴戟天  角色2 ： 牡丹 牡丹皮 延胡索 熟地黄 白薇 茯苓 白茅根 贯众 刘寄奴 蒲黄  角色3 ： 当归 芍药 蒲黄 阿胶 生地黄 赤芍 藕节 肉桂 白芍 白薇	吐血 鼻衄 咳血 便血 少气 口臭 咽喉痛 食欲不振 耳内流脓 转筋
角色0 ： 牛蒡 牛蒡子 连翘 荆芥 薄荷 桔梗 淡豆豉 金银花 西河柳 沉香  角色1 ： 荆芥 连翘 桔梗 防风 薄荷 紫草 蝉蜕 木通 淡豆豉 人中黄  角色2 ： 金银花 连翘 天花粉 玄参 蝉蜕 土茯苓 板蓝根 大青叶 蒲公英 白鲜皮  角色3 ： 薄荷 荷叶 荆芥 绿豆 木香 浮萍 贯众 青黛 橘红 香附	麻疹 鼻塞 丹毒 口渴 杨梅疮 谵语 咳嗽 痄腮 小儿丹毒 寒战
角色0 ： 紫菀 款冬花 百合 百部 天门冬 白前 五味子 蛤蚧 射干 耳草  角色1 ： 桑 桑白皮 五味子 紫菀 桔梗 款冬花 马兜铃 麻黄 知母 茯苓  角色2 ： 杏 杏仁 苦杏仁 紫苏叶 葶苈子 紫苏子 麻黄 浙贝母 阿胶 陈皮  角色3 ： 杏仁 杏 紫菀 知母 天门冬 桑 马兜铃 葛根 紫苏叶 珍珠母	咳嗽 气喘 喉痒 妊娠咳嗽 鼻衄 臁疮 身重 目昏 小便黄赤 难产
角色0 ： 甘草 陈皮 茯苓 桔梗 半夏 麦门冬 乌梅 干姜 山楂 黄连  角色1 ： 半夏 枳壳 桔梗 陈皮 甘草 茯苓 柴胡 天冬 白术 枳实  角色2 ： 前胡 桔梗 枳壳 旋覆花 紫苏叶 半夏 白矾 黄芩 柴胡 麻黄  角色3 ： 甘草 茯苓 陈皮 半夏 桔梗 苍术 大黄 党参 当归 丹参	咳嗽 头痛 阴疮 喷嚏 舌苔黄 壮热 骨痛 腰重 神昏 鼻衄
角色0 ： 白术 陈皮 半夏 甘草 枳实 炙甘草 厚朴 枳壳 木香 竹茹  角色1 ： 生姜 半夏 枳实 厚朴 竹茹 白术 大腹皮 柿蒂 百草霜 僵蚕  角色2 ： 人参 茯苓 白术 甘草 生姜 乌梅 炙甘草 白矾 当归 附子  角色3 ： 陈皮 半夏 茯苓 甘草 人参 炙甘草 生姜 厚朴 柴胡 白芍	腹满 干呕 呃逆 呕吐 舌苔白 心下痞 口淡 多唾 舌苔白腻 头重
角色0 ： 甘草 麻黄 桔梗 橘红 杏仁 荆芥 猪牙皂 鸡子 紫苏叶 防风  角色1 ： 前胡 半夏 枳壳 桔梗 旋覆花 瓜蒌 紫菀 紫草 天门冬 萝卜  角色2 ： 杏仁 杏 麻黄 橘红 百合 前胡 紫苏子 巴豆 寒水石 射干  角色3 ： 杏 杏仁 麻黄 羚羊角 桔梗 百合 橘红 石膏 前胡 款冬花	咳嗽 气喘 耳聋 尿痛 寒热往来 腹痛 胃痛 壮热 咳血 小儿痞块
角色0 ： 甘草 黄芩 柴胡 黄连 石菖蒲 干姜 知母 牛膝 葛根 琥珀  角色1 ： 甘草 当归 芍药 麦门冬 白芍 川芎 升麻 石膏 五味子 大黄  角色2 ： 人参 甘草 黄连 茯苓 炙甘草 乌梅 干姜 陈皮 川芎 滑石  角色3 ： 甘草 柴胡 枳壳 黄芩 炙甘草 夏枯草 麦门冬 百草霜 大豆 乌梅	口苦 舌干 胁痛 咽干 耳聋 头重 胸痛 鼻衄 反胃 阴痛
角色0 ： 三棱 莪术 青皮 槟榔 枳实 阿魏 萝卜 草果 肉桂 五灵脂  角色1 ： 神曲 麦芽 山楂 莱菔子 鸡内金 枳实 厚朴 谷芽 青皮 大麦  角色2 ： 青皮 陈皮 香附 砂仁 姜黄 乌药 厚朴 草果 佛手 片姜黄  角色3 ： 陈皮 神曲 山楂 砂仁 香附 苍术 枳实 麦芽 萝卜 干漆	吞酸 积滞 恶心 嘈杂 嗳气 食欲不振 胃痛 呕吐 胸闷 腹泻
角色0 ： 甘草 芍药 麻黄 白芍 升麻 生姜 干姜 大黄 知母 蒲黄  角色1 ： 生姜 大枣 葱白 桂枝 芍药 人参 当归 冰片 黄芩 皂荚  角色2 ： 麻黄 石膏 甘草 葛根 桂枝 黄芩 防风 竹茹 山茱萸 百合  角色3 ： 甘草 麻黄 桂枝 芍药 细辛 葱白 寒水石 大枣 升麻 犀角	头痛 恶寒 恶风 无汗 项强 月经过多 舌肿 头汗 丹毒 胁痛
角色0 ： 芍药 赤芍 甘草 柴胡 当归 白术 葛根 炙甘草 秦艽 白芍  角色1 ： 芍药 赤芍 大黄 黄芩 羌活 鳖甲 秦艽 炮姜 乌梅 山药  角色2 ： 甘草 黄芩 柴胡 枳壳 升麻 芍药 半夏 石膏 陈皮 白术  角色3 ： 赤芍 芍药 当归 枳壳 茯苓 大黄 柴胡 蛇床子 萝卜 桑寄生	壮热 头痛 四肢疼痛 寒热往来 腹满 弄舌 干呕 黄汗 浮肿 大便下血
角色0 ： 五味子 甘草 人参 麦门冬 大枣 白石英 半夏 石菖蒲 玄参 沉香  角色1 ： 人参 茯苓 甘草 五味子 麦门冬 当归 槐角 远志 甘遂 郁金  角色2 ： 人参 茯苓 五味子 当归 知母 柴胡 天门冬 侧柏叶 半夏 厚朴  角色3 ： 麦门冬 天门冬 生地黄 远志 柴胡 人参 陈皮 磁石 黄连 炙甘草	短气 少气 吐血 背痛 不寐 足热 神昏 胸闷 咳嗽 面色白
角色0 ： 当归 白芍 川芎 芍药 香附 陈皮 甘草 枳壳 黄芩 茜草  角色1 ： 白芍 当归 川芎 熟地黄 白芷 青木香 青皮 赤石脂 神曲 蜂蜜  角色2 ： 当归 川芎 白芍 阿胶 白术 藁本 葛根 陈皮 射干 炙甘草  角色3 ： 香附 川芎 白芍 熟地黄 益母草 砂仁 当归 肉桂 人参 白术	腹痛 胎动不安 不孕 胎漏 头昏 头晕 月经过多 里急后重 吐血 带状疱疹
角色0 ： 赤石脂 龙骨 牡蛎 禹余粮 紫石英 鹿茸 白薇 海螵蛸 续断 大黄  角色1 ： 阿胶 地榆 艾叶 蒲黄 槐花 续断 当归 小蓟 侧柏叶 卷柏  角色2 ： 当归 白芍 芍药 白术 阿胶 生地黄 川芎 延胡索 鸡子 蜂蜜  角色3 ： 当归 阿胶 艾叶 白芍 干姜 芍药 续断 乌药 牡蛎 黄芩	崩漏 便血 崩中 漏下 脱肛 尿血 大便下血 吐血 腹痛 胎漏
角色0 ： 犀角 升麻 石膏 黄连 寒水石 羚羊角 石菖蒲 柴胡 当归 白矾  角色1 ： 黄芩 大黄 栀子 龙胆 枳实 芍药 青黛 苦参 柴胡 升麻  角色2 ： 黄芩 大黄 黄连 黄柏 栀子 龙胆 寒水石 羚羊角 绿豆 木通  角色3 ： 黄芩 栀子 黄连 大黄 犀角 柴胡 厚朴 钩藤 酸枣仁 葛根	烦躁 壮热 谵语 胎毒 鼻干 发狂 面色青 腹满 唇肿 心下痞
角色0 ： 生姜 半夏 厚朴 甘草 白矾 苍术 藿香 茯苓 黄连 枳实  角色1 ： 甘草 茯苓 半夏 人参 白术 陈皮 橘红 枳实 干姜 大枣  角色2 ： 生姜 厚朴 半夏 竹沥 地龙 高良姜 硫黄 木香 绿豆 牡蛎  角色3 ： 白术 茯苓 半夏 枳实 生姜 干姜 甘草 陈皮 肉桂 白芍	呕吐 恶心 小儿呕吐 心下痞 呵欠 身痛 浮肿 妊娠呕吐 胃痛 目昏
角色0 ： 甘草 人参 茯苓 白术 当归 炙甘草 麦门冬 泽泻 枳壳 羌活  角色1 ： 茯苓 白术 人参 白芍 川芎 牡蛎 石菖蒲 寒水石 苍术 樟脑  角色2 ： 当归 甘草 白芍 白术 肉桂 川芎 附子 炙甘草 荆芥 青黛  角色3 ： 当归 白芍 芍药 白术 人参 川芎 甘草 五味子 红花 党参	心烦 五心烦热 咽干 潮热 腹痛 臂痛 头摇 善怒 产后血崩 面色青
角色0 ： 人参 白术 甘草 茯苓 芍药 琥珀 山药 紫苏叶 瓜蒂 丹参  角色1 ： 当归 甘草 干姜 乌梅 茯苓 五味子 人参 升麻 炮姜 荆芥  角色2 ： 干姜 附子 白术 甘草 吴茱萸 陈皮 黄连 茯苓 白芍 郁金  角色3 ： 乌梅 诃子 罂粟壳 罂粟 甘草 石榴 厚朴 石榴皮 地榆 附子	腹痛 里急后重 腹泻 产后腹痛 多唾 头昏 脱肛 臂痛 善惊 漏睛
角色0 ： 天麻 全蝎 僵蚕 白附子 附子 天南星 朱砂 乌梢蛇 海螵蛸 白鲜皮  角色1 ： 牛黄 天竺黄 琥珀 雄黄 朱砂 麝香 胆南星 钩藤 珍珠 牛胆  角色2 ： 全蝎 麝香 僵蚕 蜈蚣 天麻 朱砂 蝉蜕 青黛 胆南星 犀角  角色3 ： 僵蚕 天南星 白附子 天麻 附子 麝香 全蝎 犀角 赤石脂 半夏	慢惊 急惊 痫 神昏 四肢抽搐 面色青 脱肛 恶寒发热 唇肿 妊娠咳嗽
角色0 ： 麦冬 沙参 天冬 北沙参 石斛 玉竹 丹参 南沙参 莲子 五味子  角色1 ： 甘草 知母 石膏 地骨皮 黄芩 玄参 葛根 瓜蒌 白芍 秦艽  角色2 ： 麦冬 玄参 天花粉 桔梗 天冬 白芍 郁金 浙贝母 大枣 苦杏仁  角色3 ： 知母 黄柏 黄连 黄芩 甘草 石膏 川芎 大豆 玄参 羚羊角	口渴 咽干 鼻干 心烦 消瘦 烦躁 舌干 口臭 不寐 头昏
角色0 ： 防风 菊花 羚羊角 羌活 蔓荆子 龙胆 酸枣仁 细辛 芍药 全蝎  角色1 ： 防风 荆芥 羌活 独活 川芎 菊花 苦参 萝卜 白芷 何首乌  角色2 ： 菊花 苦参 防风 细辛 苍耳 白鲜皮 白芷 苍耳子 地肤子 羌活  角色3 ： 藜 蒺藜 木贼 石决明 藜芦 青葙 青葙子 决明子 菊花 茺蔚子	目昏 皮肤瘙痒 流泪 远视 拳毛倒睫 头痛 胬肉攀睛 鼻塞 近视 舌强
角色0 ： 车前 车前子 木通 海金沙 车前草 冬瓜 槐花 绿豆 当归 山豆根  角色1 ： 泽泻 猪苓 茯苓 黄柏 苍术 椒目 防风 羚羊角 滑石粉 茵陈  角色2 ： 木通 滑石 大黄 瞿麦 通草 防己 丹参 龙胆 茯苓 木香  角色3 ： 木通 滑石 瞿麦 冬葵 冬葵子 石韦 通草 王不留行 枳壳 白茅根	小便不通 小便不利 尿血 难产 阴疮 大便溏 妊娠小便不通 咽肿 胞衣不下 舌苔黄
角色0 ： 当归 红花 丹参 赤芍 延胡索 泽兰 益母草 苏木 蒲黄 刘寄奴  角色1 ： 桃 桃仁 水蛭 虻虫 鬼箭羽 核桃仁 红花 赤芍 乌药 僵蚕  角色2 ： 桃 桃仁 红花 赤芍 泽兰 川芎 苏木 虎杖 炙甘草 白术  角色3 ： 当归 川芎 肉桂 大黄 炮姜 丹参 甘草 大豆 桂枝 乌梅	腹痛 难产 恶露不下 胸痛 胁痛 胞衣不下 胸闷 少腹痛 闭经 阴痒
角色0 ： 藿香 厚朴 木瓜 香薷 广藿香 白扁豆 紫苏叶 神曲 木香 大腹皮  角色1 ： 丁香 木香 藿香 沉香 檀香 甘松 零陵香 降香 半夏 苏合香  角色2 ： 陈皮 苍术 香附 砂仁 厚朴 炮姜 薄荷 佩兰 紫苏叶 茯苓  角色3 ： 厚朴 砂仁 藿香 陈皮 苍术 草果 桔梗 山楂 黄连 夏枯草	呕吐 反胃 腹痛 噎膈 转筋 恶心 上吐下泻 腹泻 胸闷 产后腹痛
角色0 ： 杜仲 牛膝 续断 狗脊 虎骨 补骨脂 木瓜 茜草 乌药 炮姜  角色1 ： 没药 乳香 川乌 地龙 五灵脂 草乌 乌头 骨碎补 木鳖子 自然铜  角色2 ： 木瓜 独活 威灵仙 川乌 红花 羌活 牛膝 草乌 秦艽 桂枝  角色3 ： 牛膝 五加 五加皮 杜仲 石斛 薏苡仁 丹参 海桐皮 酸枣仁 独活	腰痛 瘫痪 骨痛 半身不遂 四肢麻木 关节疼痛 腰膝无力 产后腰痛 足痛 头摇
角色0 ： 桑 桑白皮 防己 赤小豆 桑螵蛸 商陆 桑枝 泽漆 秦皮 紫苏叶  角色1 ： 大腹皮 槟榔 枳壳 木香 茯苓 木通 防己 白术 香附 人参  角色2 ： 桑 桑寄生 桑叶 桑螵蛸 贯众 白鲜皮 桑枝 葶苈子 桔梗 忍冬藤  角色3 ： 茯苓 甘草 枳壳 人参 麦门冬 槟榔 紫苏子 泽泻 薏苡仁 当归	浮肿 气喘 小便不利 小儿口疮 少腹痛 胎动不安 头胀 寒战 漏睛 舌强
角色0 ： 远志 酸枣仁 柏子仁 石菖蒲 五味子 丹参 龙齿 珍珠 紫石英 珍珠母  角色1 ： 何首乌 枸杞子 女贞 菟丝子 女贞子 熟地黄 淫羊藿 黄精 黄芪 制何首乌  角色2 ： 鹿角 菟丝子 枸杞子 山药 鹿角胶 熟地黄 杜仲 鹿茸 补骨脂 肉苁蓉  角色3 ： 党参 丹参 黄芪 山药 麦冬 三七 白芍 龙眼 龙眼肉 紫河车	头晕 心悸 健忘 多梦 胸闷 疲乏 食欲不振 须发早白 脱发 头昏
角色0 ： 干姜 附子 吴茱萸 硫黄 肉桂 厚朴 荜澄茄 高良姜 木香 黄芩  角色1 ： 附子 干姜 吴茱萸 细辛 高良姜 乌头 青黛 胡椒 贯众 水蛭  角色2 ： 干姜 附子 吴茱萸 肉桂 白茅根 天麻 炮姜 旋覆花 硫黄 蜥蜴  角色3 ： 附子 干姜 硫黄 吴茱萸 阳起石 大枣 黄连 柏子仁 延胡索 百草霜	腹痛 腹冷 手足厥冷 转筋 面色青 头重 舌干 上吐下泻 远视 心烦
角色0 ： 甘草 麦门冬 茯苓 人参 石膏 芍药 远志 赤芍 生地黄 磁石  角色1 ： 甘草 人参 麦门冬 麻黄 桔梗 羚羊角 知母 竹沥 防风 枳壳  角色2 ： 甘草 人参 茯苓 枳壳 黄芩 白术 知母 大黄 黄连 竹茹  角色3 ： 麦门冬 犀角 升麻 羚羊角 地骨皮 玄参 前胡 葛根 枳壳 防风	烦躁 心烦 壮热 牙痛 口臭 痫 吐血 带状疱疹 头重 呵欠
角色0 ： 麝香 朱砂 雄黄 牛黄 郁金 犀角 轻粉 天麻 龙齿 莨菪  角色1 ： 巴豆 朱砂 麝香 赭石 雄黄 郁金 巴豆霜 代赭石 轻粉 薄荷  角色2 ： 牛黄 钩藤 龙齿 犀角 蛇蜕 朱砂 琥珀 蜂房 天竺黄 白鲜皮  角色3 ： 麝香 朱砂 青黛 雄黄 牛黄 蟾酥 白矾 熊胆 蜗牛 斑蝥	痫 神昏 慢惊 急惊 蟹睛 言语错乱 足颤 鼻痒 腰痛 尿血
角色0 ： 巴豆 甘遂 芫花 五灵脂 大戟 干漆 三棱 莪术 五倍子 黄柏  角色1 ： 当归 香附 白芍 川芎 肉桂 苍术 生姜 阿胶 橘红 三七  角色2 ： 茴香 小茴香 木香 川楝子 延胡索 葫芦 硫黄 胡芦巴 沉香 八角茴香  角色3 ： 香附 乌药 沉香 木香 附子 五灵脂 巴戟天 鹿茸 川芎 白芍	白带 赤白带 咳血 弄舌 带状疱疹 闭经 浮肿 偏头痛 畏寒 小儿口疮
角色0 ： 郁李 郁李仁 槟榔 防己 木香 桑 附子 大黄 酸枣仁 茯苓  角色1 ： 菟丝子 鹿茸 肉苁蓉 牛膝 蛇床子 石斛 杜仲 补骨脂 覆盆子 山茱萸  角色2 ： 牛膝 山茱萸 磁石 石斛 杜仲 五味子 肉苁蓉 远志 泽泻 巴戟天  角色3 ： 牵牛 槟榔 牵牛子 大黄 木香 吴茱萸 茴香 大腹皮 黄柏 猪牙皂	耳聋 腰痛 浮肿 腰重 小便频数 腰脊痛 腰膝无力 阴痒 头昏 短气
