乳香 没药 雄黄 轻粉 麝香 冰片 血竭 白及 朱砂 穿山甲	瘰疬 臁疮 无名肿毒 杨梅疮 牙痛 湿疮 胎毒 难产 粉刺 拳毛倒睫
甘草 茯苓 白术 半夏 人参 陈皮 益智 益智仁 橘红 莲子	呕吐 恶心 自汗 遗尿 心下痞 腹满 小儿遗尿 气喘 目昏 心下悸
桃 桃仁 当归 红花 茴香 肉桂 赤芍 延胡索 小茴香 丹参	腹痛 腰痛 胁痛 恶露不下 胸痛 胞衣不下 大便秘结 少腹痛 腹冷 闭经
杜仲 牛膝 菟丝子 山茱萸 肉苁蓉 石斛 五味子 鹿茸 续断 山药	腰痛 小便频数 头晕 目昏 耳聋 盗汗 不孕 遗尿 腰膝无力 头昏
芍药 赤芍 甘草 当归 黄芩 柴胡 生地黄 麦门冬 半夏 牛膝	头痛 壮热 四肢疼痛 恶风 项强 自汗 少气 崩中 寒热往来 口甜
木香 槟榔 三棱 青皮 巴豆 莪术 枳壳 沉香 五灵脂 茴香	腹痛 积滞 里急后重 反胃 噎膈 腹满 小儿腹痛 腹中痞块 善太息 臂痛
防风 菊花 川芎 细辛 白芷 薄荷 荆芥 羌活 蔓荆子 藁本	目昏 头痛 鼻塞 头昏 流泪 偏头痛 牙痛 远视 拳毛倒睫 皮肤瘙痒
干姜 白术 厚朴 生姜 附子 当归 吴茱萸 木香 肉桂 高良姜	腹痛 肠鸣 里急后重 腹满 腹冷 咽喉痛 转筋 少腹痛 胃痛 心下悸
薄荷 连翘 荆芥 牛蒡 桔梗 竹叶 金银花 牛蒡子 天花粉 淡竹	口渴 麻疹 头痛 咳嗽 鼻塞 丹毒 杨梅疮 谵语 痄腮 神昏
丁香 豆蔻 木香 沉香 肉豆蔻 白豆蔻 砂仁 草豆蔻 藿香 檀香	呕吐 恶心 肠鸣 吞酸 呃逆 腹冷 小儿呕吐 口臭 胸闷 牙痛
杏 杏仁 紫菀 款冬花 麻黄 桑 桑白皮 苦杏仁 五味子 百合	咳嗽 气喘 痫 神昏 耳聋 喉痒 发狂 远视 消瘦 阴痒
防风 独活 羌活 麻黄 羚羊角 秦艽 五加 五加皮 细辛 防己	口噤 恶风 项强 角弓反张 四肢拘急 舌强 言语错乱 舌苔白 足颤 四肢强直
陈皮 神曲 香附 山楂 砂仁 麦芽 青皮 厚朴 枳实 苍术	吞酸 呕吐 嘈杂 恶心 嗳气 食欲不振 积滞 胃痛 腹泻 腹满
川乌 牛膝 乌头 草乌 白芷 威灵仙 当归 地龙 木瓜 五灵脂	半身不遂 瘫痪 腰痛 骨痛 四肢麻木 关节疼痛 臂痛 头痛 耳聋 小便不利
甘草 大黄 黄芩 玄参 升麻 连翘 桔梗 射干 犀角 夏枯草	瘰疬 丹毒 头痛 阴疮 咽肿 舌肿 咽喉痛 胎毒 脱肛 小儿丹毒
防风 川芎 白芷 羌活 细辛 荆芥 苍术 麻黄 独活 桂枝	恶寒 头痛 无汗 身痛 恶寒发热 鼻塞 身重 呵欠 健忘 口渴
附子 僵蚕 天麻 白附子 全蝎 天南星 麝香 朱砂 蜈蚣 雄黄	慢惊 痫 急惊 神昏 口噤 角弓反张 偏头痛 头痛 半身不遂 寒战
泽泻 木通 滑石 车前 车前子 茯苓 猪苓 瞿麦 冬葵 通草	小便不通 小便不利 难产 尿血 小便黄赤 浮肿 痱子 妊娠小便不通 吐血 肥胖
槟榔 桑 枳壳 大黄 木香 牵牛 防己 郁李 郁李仁 大腹皮	浮肿 气喘 小便不利 腹痛 大便秘结 舌干 妊娠心腹胀满 发狂 产后浮肿 消瘦
附子 干姜 细辛 吴茱萸 硫黄 肉桂 乌头 白术 磁石 大豆	耳聋 手足厥冷 短气 少气 面色青 背痛 腹冷 转筋 腹痛 寒战
黄连 黄柏 黄芩 藜 蒺藜 苦参 知母 甘草 栀子 生地黄	烦躁 头痛 牙痛 皮肤瘙痒 心烦 耳聋 舌肿 流泪 牙龈肿痛 舌疮
朱砂 牛黄 麝香 雄黄 琥珀 冰片 天竺黄 钩藤 珍珠 龙齿	痫 神昏 急惊 谵语 发狂 小儿发热 四肢抽搐 弄舌 言语错乱 产后浮肿
人参 茯苓 白术 甘草 当归 肉桂 白芍 山药 炙甘草 牡蛎	自汗 盗汗 恶风 畏寒 背痛 脱肛 气喘 恶寒 头痛 浮肿
阿胶 当归 乌梅 地榆 蒲黄 艾叶 赭石 桑 罂粟 桑寄生	吐血 便血 崩漏 漏下 脱肛 尿血 腹痛 胎动不安 鼻衄 咳嗽
甘草 石膏 葛根 麻黄 黄芩 柴胡 升麻 知母 寒水石 葱白	头痛 壮热 恶寒 发狂 咽干 蟹睛 喷嚏 腰脊痛 浮肿 心悸
生姜 半夏 甘草 人参 大枣 竹茹 桂枝 葱白 枳实 厚朴	干呕 短气 呕吐 恶寒 腹满 心下痞 舌苔白 多唾 呃逆 头痛
陈皮 厚朴 半夏 藿香 苍术 茯苓 木瓜 木香 砂仁 香薷	呕吐 转筋 恶心 腹痛 头痛 胸闷 腹泻 大便溏 上吐下泻 无汗
甘草 升麻 犀角 麦门冬 石膏 黄芩 玄参 羚羊角 知母 栀子	烦躁 壮热 鼻干 心烦 咽喉痛 口中生疮 头晕 寒战 崩中 独语
当归 白芍 芍药 川芎 生地黄 甘草 熟地黄 白术 石膏 地骨皮	吐血 鼻衄 胁痛 大便下血 耳聋 脱肛 目昏 便血 头热 崩中
当归 川芎 白芍 香附 乌药 益母草 白术 砂仁 肉桂 熟地黄	腹痛 胎动不安 头晕 难产 胎漏 不孕 产后腹痛 头昏 崩漏 经行腹痛
茯苓 甘草 人参 白术 半夏 陈皮 炙甘草 大麦 苍术 生姜	咳嗽 腹满 身重 气喘 头重 目昏 口淡 消瘦 脱肛 呵欠
远志 山药 丹参 麦冬 党参 石菖蒲 五味子 黄芪 酸枣仁 柏子仁	心悸 健忘 头晕 多梦 胸闷 疲乏 不寐 食欲不振 头昏 须发早白
桑 麦冬 桔梗 橘红 沙参 枇杷 枇杷叶 川贝母 瓜蒌 芥子	咳嗽 口渴 咽干 气喘 咳血 胸闷 咳痰 胁痛 喉痒 大便秘结
大黄 黄芩 栀子 黄连 枳实 茵陈 柴胡 郁金 黄柏 龙胆	烦躁 发黄 谵语 大便秘结 发狂 腹满 舌苔黄 头汗 舌苔黄腻 黄汗
柴胡 甘草 知母 鳖甲 地骨皮 枳壳 秦艽 青蒿 乌梅 常山	潮热 盗汗 寒热往来 口苦 但热不寒 心烦 脱肛 舌干 疳积 白带
人参 麦门冬 甘草 茯苓 五味子 天门冬 远志 地骨皮 白石英 紫菀	口苦 舌干 咽干 短气 少气 远视 骨痛 近视 噎膈 腰重
桔梗 前胡 枳壳 甘草 半夏 旋覆花 陈皮 紫苏叶 瓜蒌 橘红	咳嗽 鼻塞 盗汗 小便黄赤 壮热 腹痛 头痛 胃痛 头昏 多唾
黄连 青黛 麝香 白矾 胡黄连 芦荟 巴豆 使君子 芜荑 龙胆	壮热 疳积 消瘦 口臭 腹痛 痫 吐血 潮热 小儿口疮 神昏
甘草 茯苓 人参 白术 当归 炙甘草 升麻 白芍 黄柏 泽兰	心烦 五心烦热 短气 小便黄赤 足热 气喘 唇肿 小便不利 小儿呕吐 腹泻
当归 龙骨 牡丹 牡蛎 牡丹皮 赤石脂 芍药 白芍 艾叶 阿胶	白带 赤白带 崩中 漏下 崩漏 脱肛 腹冷 头汗 吐血 脐疮
