芍药 赤芍 当归 黄芩 大黄 柴胡 龙胆 枳实 泽兰 浮萍	壮热 头痛 四肢疼痛 胎毒 小儿丹毒 鼻干 阴痒 舌上出血 舌苔白 肠鸣
当归 川芎 香附 白芍 熟地黄 乌药 益母草 白薇 肉桂 延胡索	白带 赤白带 不孕 崩漏 经行腹痛 胎毒 漏下 腹痛 小儿啼哭 舌干
牛黄 朱砂 麝香 琥珀 天竺黄 钩藤 雄黄 犀角 龙齿 珍珠	痫 神昏 壮热 烦躁 急惊 发狂 四肢抽搐 心烦 头痛 角弓反张
黄连 黄柏 青黛 胡黄连 芦荟 龙胆 使君子 芜荑 雷丸 鹤虱	疳积 壮热 腹痛 口臭 消瘦 潮热 盗汗 阴疮 吐血 鼻痒
神曲 陈皮 山楂 砂仁 香附 麦芽 枳实 青皮 苍术 厚朴	吞酸 呕吐 嘈杂 嗳气 食欲不振 积滞 腹泻 反胃 恶心 胃痛
甘草 人参 茯苓 麦门冬 白术 五味子 薏苡仁 附子 鸡子 地骨皮	心烦 五心烦热 咽干 不寐 腰重 耳聋 妊娠心烦 头痛 赤脉传睛 产后腹痛
龙骨 牡蛎 赤石脂 山药 鹿角 白矾 赭石 鹿角胶 禹余粮 芡实	盗汗 崩漏 崩中 白带 脱肛 自汗 遗尿 便血 吐血 漏下
桔梗 前胡 枳壳 半夏 橘红 瓜蒌 旋覆花 紫苏叶 法半夏 川贝母	咳嗽 胸闷 胁痛 喉痒 咳痰 目昏 气喘 腹痛 多唾 急惊
僵蚕 天麻 附子 白附子 全蝎 天南星 麝香 蜈蚣 朱砂 蝉蜕	慢惊 急惊 痫 口噤 角弓反张 神昏 偏头痛 谵语 胸闷 皮肤瘙痒
牛膝 杜仲 当归 续断 五加 五加皮 木瓜 独活 肉桂 薏苡仁	腰痛 四肢麻木 半身不遂 杨梅疮 骨痛 关节疼痛 腰脊痛 产后腰痛 足痛 头重
茯苓 甘草 白术 人参 半夏 益智 益智仁 陈皮 当归 竹茹	呕吐 烦躁 恶心 胁痛 臂痛 腹满 遗尿 目昏 口渴 少气
升麻 犀角 麦门冬 黄芩 甘草 石膏 玄参 栀子 羚羊角 射干	烦躁 壮热 鼻干 咽喉痛 喷嚏 言语错乱 心烦 咽肿 唇肿 小儿丹毒
川乌 乌头 附子 白芷 草乌 细辛 地龙 五灵脂 天麻 川芎	瘫痪 半身不遂 头痛 骨痛 耳聋 牙痛 皮肤瘙痒 恶风 腹冷 关节疼痛
甘草 茯苓 人参 乌梅 陈皮 白术 半夏 罂粟 罂粟壳 枳壳	咳嗽 腹痛 脱肛 咽干 里急后重 气喘 心烦 胎毒 小便频数 小儿腹痛
当归 生地黄 芍药 白芍 甘草 川芎 黄柏 熟地黄 郁金 麦门冬	吐血 鼻衄 大便下血 浮肿 呕吐 弄舌 咳血 月经过多 目昏 便血
防风 菊花 藜 蒺藜 羌活 荆芥 苦参 羚羊角 石决明 蔓荆子	目昏 头痛 皮肤瘙痒 流泪 远视 头昏 拳毛倒睫 偏头痛 粉刺 胬肉攀睛
大黄 甘草 玄参 连翘 皂荚 黄连 郁金 芥子 白芥 白芥子	瘰疬 胁痛 丹毒 牙痛 神昏 咳嗽 粉刺 痫 咽肿 吞酸
桃 桃仁 牡丹 牡丹皮 红花 当归 赤芍 延胡索 泽兰 苏木	腹痛 胁痛 恶露不下 大便秘结 胸痛 崩中 发狂 难产 闭经 心烦
黄芩 大黄 栀子 黄连 黄柏 茵陈 枳实 龙胆 茵陈蒿 石膏	烦躁 发黄 大便秘结 谵语 舌苔黄 小便黄赤 壮热 腹满 头汗 舌苔黄腻
藿香 厚朴 陈皮 半夏 苍术 砂仁 木瓜 香薷 草果 广藿香	呕吐 恶心 转筋 胸闷 上吐下泻 头痛 腹泻 腹痛 大便溏 呃逆
槟榔 大黄 牵牛 木香 防己 郁李 郁李仁 枳壳 甘遂 大腹皮	浮肿 小便不利 气喘 大便秘结 烦躁 消瘦 口噤 拳毛倒睫 妇人阴冷 舌卷
甘草 白术 人参 茯苓 陈皮 半夏 炙甘草 生姜 丹参 姜黄	恶寒 头痛 身重 头重 短气 小便黄赤 舌强 腰重 不射精 寒战
杏 杏仁 麻黄 苦杏仁 紫苏子 葶苈子 马兜铃 柿霜 浙贝母 白果	咳嗽 气喘 妊娠咳嗽 耳聋 头昏 头痛 胸痛 心下痞 喉痒 痫
薄荷 连翘 荆芥 桔梗 牛蒡 牛蒡子 金银花 荷叶 天花粉 蝉蜕	麻疹 头痛 丹毒 鼻塞 谵语 咳嗽 痄腮 神昏 头晕 烦躁
桑 桑白皮 桔梗 桑寄生 桑叶 五味子 地骨皮 桑螵蛸 甘草 桑枝	咳嗽 气喘 浮肿 咽干 头晕 口渴 恶风 胸痛 心悸 胎动不安
乳香 没药 轻粉 麝香 血竭 冰片 雄黄 穿山甲 儿茶 蓖麻	臁疮 无名肿毒 瘰疬 杨梅疮 湿疮 胎毒 小儿口疮 半身不遂 阴疮 胎动不安
麦冬 玄参 竹叶 知母 沙参 石膏 天冬 淡竹 天花粉 淡竹叶	口渴 咽干 心烦 谵语 发狂 烦躁 神昏 咳嗽 肥胖 舌干
当归 白芍 川芎 芍药 白术 益母草 天门冬 陈皮 酸枣仁 紫草	腹痛 难产 胎动不安 胁痛 胞衣不下 产后腹痛 胎漏 身重 面色青 盗汗
甘草 半夏 茯苓 人参 白术 陈皮 泽泻 麦门冬 大腹皮 牡丹	呕吐 恶心 目昏 小儿呕吐 舌苔白 急惊 多唾 心烦 谵语 腹冷
甘草 人参 茯苓 白术 半夏 柴胡 防风 川芎 贯众 萝卜	头痛 自汗 壮热 烦躁 少气 恶风 咳嗽 盗汗 口渴 发狂
甘草 白术 茯苓 人参 当归 炙甘草 肉桂 山药 白芍 炮姜	自汗 消瘦 畏寒 恶寒 大便溏 寒战 口淡 腹痛 头晕 弄舌
木香 茴香 沉香 丁香 檀香 小茴香 乌药 砂仁 川楝子 香附	腹痛 呕吐 呃逆 胃痛 腹冷 胁痛 腰痛 恶心 口臭 气喘
豆蔻 丁香 木香 肉豆蔻 沉香 白豆蔻 草豆蔻 高良姜 砂仁 诃子	呕吐 肠鸣 恶心 吞酸 腹冷 烦躁 胸闷 口臭 嗳气 里急后重
甘草 防风 川芎 桂枝 苍术 麻黄 羌活 白芷 桔梗 葱白	恶寒 无汗 身痛 恶寒发热 恶风 呵欠 腰脊痛 身重 唇肿 舌苔白
远志 丹参 酸枣仁 石菖蒲 党参 山药 黄芪 五味子 熟地黄 何首乌	心悸 健忘 头晕 多梦 疲乏 胸闷 食欲不振 不寐 须发早白 脱发
菟丝子 五味子 牛膝 山茱萸 肉苁蓉 杜仲 鹿茸 远志 石斛 山药	耳聋 头晕 腰痛 小便频数 不孕 目昏 健忘 盗汗 腰膝无力 畏寒
白芷 细辛 川芎 防风 羌活 薄荷 荆芥 藁本 蔓荆子 苍耳	头痛 鼻塞 头昏 舌苔白 转筋 心烦 发狂 大便下血 头热 口淡
木通 泽泻 滑石 车前 车前子 猪苓 瞿麦 通草 冬葵 冬葵子	小便不通 小便不利 尿血 难产 妊娠小便不通 咳痰 小便黄赤 头汗 乳汁不行 痱子
黄芩 甘草 柴胡 大黄 栀子 黄连 升麻 赤芍 生地黄 白矾	口苦 舌干 咽干 寒热往来 耳聋 身痛 腰重 小便黄赤 项强 赤膜下垂
枳壳 木香 陈皮 厚朴 槟榔 青皮 半夏 枳实 苍术 大腹皮	腹痛 里急后重 反胃 噎膈 大便下血 脱肛 心下痞 但热不寒 耳聋 大便溏
干姜 附子 吴茱萸 硫黄 肉桂 细辛 人参 生姜 莲子 甘草	腹痛 手足厥冷 转筋 面色青 腹冷 耳聋 呕吐 舌肿 四肢拘急 崩漏
巴豆 三棱 木香 槟榔 莪术 青皮 大黄 五灵脂 干漆 巴豆霜	腹痛 积滞 恶心 腹满 消瘦 目昏 小儿发热 鼻干 小儿腹泻 瞳神散大
人参 干姜 附子 茯苓 白术 甘草 细辛 郁金 橘红 荷叶	短气 少气 背痛 心下痞 舌苔白 自汗 转筋 恶风 脐疮 阴痒
阿胶 当归 蒲黄 白芍 地榆 艾叶 槐花 三七 侧柏叶 续断	吐血 便血 崩漏 漏下 胎动不安 尿血 胎漏 崩中 咳血 腹痛
柴胡 知母 地骨皮 鳖甲 秦艽 枳壳 青蒿 甘草 常山 升麻	潮热 盗汗 寒热往来 但热不寒 疳积 舌干 背痛 胁痛 身重 脱肛
防风 独活 羌活 麻黄 细辛 羚羊角 秦艽 防己 白鲜皮 竹沥	口噤 项强 恶风 角弓反张 四肢拘急 舌强 四肢强直 头摇 善怒 咽肿
生姜 半夏 厚朴 大枣 竹茹 枳实 甘草 小麦 薤白 芦根	腹满 干呕 短气 心下痞 背痛 寒热往来 头昏 无汗 舌强 多唾
紫菀 五味子 麦门冬 款冬花 天门冬 桔梗 百合 枇杷 枇杷叶 百部	咳嗽 咳血 气喘 口渴 咳痰 耳聋 痫 妊娠咳嗽 吐血 呕吐
石膏 葛根 黄芩 麻黄 甘草 升麻 寒水石 前胡 知母 葱白	头痛 壮热 无汗 自汗 烦躁 牙痛 小儿发热 但热不寒 胸闷 心下悸
麝香 朱砂 雄黄 冰片 牛黄 硼砂 蟾酥 白矾 郁金 青黛	痫 神昏 牙痛 发狂 舌肿 口臭 头昏 流泪 丹毒 胸闷
