当归 白芍 川芎 白术 甘草 茯苓 香附 附子 人参 芍药	白带 赤白带 漏下 崩中 咳嗽 胎漏 腹痛 胞衣不下 头痛 呕吐
甘草 人参 枇杷 枇杷叶 半夏 生姜 竹茹 麦门冬 茯苓 芦根	干呕 咳嗽 腹痛 呕吐 头痛 壮热 烦躁 恶心 痫 心烦
甘草 石膏 川芎 防风 黄芩 柴胡 茯苓 麻黄 白芷 羌活	头痛 咳嗽 鼻干 呕吐 腹痛 心烦 壮热 烦躁 痫 浮肿
朱砂 麝香 牛黄 雄黄 冰片 琥珀 天竺黄 硼砂 钩藤 珍珠	咳嗽 腹痛 呕吐 头痛 壮热 恶心 头晕 烦躁 气喘 胸闷
甘草 白术 茯苓 人参 防风 当归 半夏 柴胡 芍药 黄芩	恶风 身重 头重 咳嗽 小便黄赤 腹痛 头痛 呕吐 足热 壮热
甘草 当归 人参 茯苓 白术 柴胡 川芎 防风 芍药 白芍	潮热 瘫痪 脱肛 咳嗽 腹痛 呵欠 呕吐 头痛 喷嚏 足颤
当归 甘草 木香 白术 茯苓 白芍 厚朴 人参 川芎 干姜	腹痛 崩漏 咳嗽 头痛 呕吐 壮热 烦躁 痫 浮肿 恶心
甘草 当归 黄芩 芍药 白芍 人参 茯苓 阿胶 生地黄 黄连	吐血 五心烦热 便血 鼻衄 咳嗽 咳血 尿血 大便下血 腹痛 头痛
甘草 人参 当归 茯苓 白术 柴胡 白芍 芍药 五味子 牡蛎	盗汗 自汗 咳嗽 遗尿 腹痛 头痛 呕吐 壮热 痫 恶心
杜仲 牛膝 菟丝子 肉苁蓉 当归 五味子 茯苓 山药 山茱萸 续断	腰痛 耳聋 咳嗽 不孕 小便频数 腹痛 目昏 头痛 呕吐 腰膝无力
桃 桃仁 大黄 红花 蒲黄 泽兰 延胡索 赤芍 姜黄 牡丹	腹痛 咳嗽 头痛 呕吐 心烦 恶心 烦躁 壮热 腰痛 浮肿
甘草 人参 黄芩 茯苓 麦门冬 芍药 当归 柴胡 大黄 犀角	烦躁 四肢疼痛 发狂 咳嗽 咽喉痛 腹痛 头痛 呕吐 壮热 痫
桑 紫菀 五味子 桑白皮 款冬花 乌梅 罂粟 罂粟壳 百合 知母	咳嗽 气喘 头痛 腹痛 呕吐 咽干 心烦 鼻塞 壮热 口渴
薄荷 连翘 牛蒡 金银花 牛蒡子 荆芥 菊花 天花粉 桔梗 板蓝根	咳嗽 头痛 口渴 恶寒 腹痛 呕吐 咽干 心烦 神昏 头晕
甘草 陈皮 茯苓 木香 白术 当归 厚朴 枳壳 人参 半夏	口渴 胸闷 里急后重 转筋 恶寒发热 食欲不振 疳积 反胃 噎膈 大便秘结
麝香 朱砂 牛黄 甘草 附子 人参 天麻 全蝎 僵蚕 白附子	痫 慢惊 神昏 急惊 咳嗽 腹痛 头痛 四肢抽搐 呕吐 壮热
车前 车前子 藜 蒺藜 滑石 瞿麦 菊花 木通 石决明 木贼	腹痛 咳嗽 头痛 呕吐 烦躁 浮肿 壮热 心烦 目昏 痫
附子 天南星 天麻 僵蚕 白附子 川乌 乌头 全蝎 朱砂 草乌	头痛 咳嗽 呕吐 腹痛 壮热 目昏 恶心 瘫痪 烦躁 鼻塞
豆蔻 肉豆蔻 丁香 诃子 草豆蔻 高良姜 檀香 胡椒 白豆蔻 沉香	腹痛 咳嗽 呕吐 头痛 恶心 烦躁 壮热 浮肿 气喘 目昏
茯苓 甘草 白术 木通 当归 泽泻 桑 木香 陈皮 人参	浮肿 小便不利 小便不通 咳嗽 发黄 腹痛 头痛 呕吐 壮热 烦躁
甘草 人参 茯苓 白术 当归 干姜 附子 半夏 芍药 生姜	短气 腹满 少气 背痛 手足厥冷 心下痞 咳嗽 腹痛 头痛 呕吐
甘草 黄芩 大黄 柴胡 石膏 防风 赤芍 桔梗 芍药 升麻	壮热 麻疹 谵语 丹毒 流泪 咳嗽 腹痛 头痛 舌肿 咽肿
乳香 没药 麝香 轻粉 雄黄 血竭 五灵脂 冰片 儿茶 草乌	腹痛 咳嗽 头痛 瘫痪 呕吐 浮肿 壮热 烦躁 恶心 痫
甘草 竹叶 麦冬 石膏 淡竹 黄芩 淡竹叶 知母 玄参 赤芍	口渴 咳嗽 腹痛 头痛 咽干 呕吐 烦躁 小便不通 神昏 壮热
甘草 茯苓 人参 半夏 当归 白术 柴胡 防风 桔梗 芍药	目昏 口苦 气喘 咽干 咳嗽 腹痛 头痛 呕吐 多唾 烦躁
滑石 白矾 乌梅 寒水石 皂荚 芥子 郁金 荷叶 白芥 白芥子	咳嗽 头痛 腹痛 呕吐 痫 恶心 烦躁 壮热 心烦 瘰疬
甘草 当归 人参 茯苓 芍药 柴胡 白芍 川芎 白术 麦门冬	心烦 舌干 腹冷 不孕 咳嗽 不寐 腹痛 头痛 呕吐 恶露不下
甘草 陈皮 木香 茯苓 香附 半夏 白术 厚朴 砂仁 神曲	吞酸 嘈杂 嗳气 呃逆 胃痛 咳嗽 腹痛 头痛 呕吐 壮热
干姜 附子 硫黄 茴香 吴茱萸 丁香 沉香 木香 肉桂 益智	腹痛 咳嗽 呕吐 头痛 腹冷 腰痛 恶心 壮热 肠鸣 烦躁
甘草 防风 川芎 细辛 白芷 羌活 桔梗 麻黄 荆芥 薄荷	鼻塞 无汗 耳聋 牙痛 头昏 咳嗽 腹痛 头痛 呕吐 壮热
杏 杏仁 麻黄 苦杏仁 瓜蒌 川贝母 石膏 防己 紫苏子 橘红	咳嗽 气喘 头痛 呕吐 腹痛 咽干 痫 壮热 胸闷 口渴
大黄 黄芩 黄连 栀子 黄柏 茵陈 木通 龙胆 苦参 升麻	咳嗽 腹痛 头痛 呕吐 发黄 大便秘结 心烦 壮热 痫 烦躁
当归 茯苓 甘草 人参 远志 白芍 五味子 白术 熟地黄 山药	头晕 健忘 心悸 多梦 疲乏 畏寒 头昏 咳嗽 须发早白 腹痛
丹参 麦冬 黄芪 党参 沙参 山药 三七 何首乌 女贞 女贞子	咳嗽 头痛 心烦 腹痛 呕吐 烦躁 食欲不振 胸闷 咽干 口渴
甘草 当归 茯苓 白术 川芎 人参 芍药 陈皮 半夏 柴胡	寒热往来 身痛 难产 面色青 咳嗽 舌苔白 腹痛 头痛 口淡 臂痛
甘草 当归 人参 白术 茯苓 川芎 白芍 柴胡 陈皮 芍药	恶寒 胁痛 消瘦 胎动不安 咳嗽 腹痛 头痛 呕吐 壮热 恶心
龙骨 地榆 牡蛎 阿胶 赤石脂 艾叶 赭石 蒲黄 石榴 紫石英	腹痛 咳嗽 头痛 呕吐 壮热 心烦 痫 烦躁 崩漏 目昏
当归 防风 甘草 川芎 牛膝 羌活 独活 附子 川乌 白芷	半身不遂 腰痛 四肢麻木 骨痛 皮肤瘙痒 关节疼痛 咳嗽 头痛 腹痛 腰膝无力
生姜 大枣 桂枝 葱白 竹茹 赤小豆 常山 鸡子 小麦 薤白	咳嗽 头痛 腹痛 呕吐 烦躁 壮热 心烦 痫 浮肿 腰痛
当归 甘草 乳香 大黄 没药 连翘 麝香 白芷 雄黄 防风	瘰疬 无名肿毒 臁疮 咳嗽 腹痛 头痛 呕吐 粉刺 小儿丹毒 恶心
黄连 青黛 胡黄连 麝香 使君子 芦荟 芜荑 熊胆 轻粉 雷丸	咳嗽 腹痛 壮热 头痛 呕吐 痫 烦躁 疳积 盗汗 心烦
甘草 防风 当归 附子 麻黄 人参 独活 茯苓 羌活 川芎	口噤 项强 角弓反张 四肢拘急 舌强 杨梅疮 咳嗽 腹痛 头痛 呕吐
巴豆 牵牛 大黄 槟榔 三棱 甘遂 牵牛子 郁李 郁李仁 莪术	咳嗽 腹痛 呕吐 头痛 积滞 浮肿 腹满 痫 气喘 壮热
甘草 杏 杏仁 桔梗 茯苓 半夏 桑 人参 麻黄 紫菀	咳嗽 腹痛 头痛 呕吐 咳痰 喉痒 壮热 烦躁 恶心 心烦
甘草 茯苓 半夏 白术 陈皮 人参 木香 厚朴 砂仁 丁香	呕吐 恶心 肠鸣 积滞 腹泻 咳嗽 头痛 腹痛 壮热 烦躁
