麦门冬 远志 五味子 人参 石菖蒲 天门冬 酸枣仁 柏子仁 生地黄 熟地黄	健忘 短气 心烦 盗汗 自汗 耳聋 咳嗽 痫 心悸 多梦
甘草 桔梗 薄荷 黄芩 荷叶 枳壳 当归 柴胡 知母 木通	咳嗽 鼻干 头痛 壮热 气喘 腹痛 烦躁 咽喉痛 胸闷 舌疮
木香 槟榔 青皮 三棱 莪术 巴豆 枳壳 大黄 甘遂 牵牛	腹痛 腹满 消瘦 里急后重 积滞 瘰疬 小便不通 噎膈 胃痛 目昏
杜仲 牛膝 菟丝子 肉苁蓉 续断 山茱萸 山药 五味子 石斛 鹿角	腰痛 耳聋 目昏 头晕 不孕 白带 腰膝无力 小便频数 盗汗 胎动不安
茯苓 泽泻 白术 甘草 猪苓 益智 茵陈 益智仁 木通 枳壳	小便不利 发黄 小便黄赤 呕吐 小便频数 舌苔黄 遗尿 自汗 舌苔黄腻 壮热
木香 香附 丁香 砂仁 沉香 乌药 陈皮 藿香 檀香 甘松	恶心 呕吐 腹痛 吞酸 呃逆 嗳气 胃痛 小儿呕吐 胎动不安 产后腹痛
甘草 人参 茯苓 麦门冬 乌梅 半夏 白术 当归 绿豆 枳实	舌干 口苦 心烦 腹痛 咳嗽 呕吐 气喘 烦躁 心悸 口渴
乳香 没药 川乌 草乌 轻粉 血竭 白芷 乌头 五灵脂 穿山甲	无名肿毒 臁疮 瘰疬 瘫痪 半身不遂 白带 骨痛 杨梅疮 赤白带 吐血
滑石 木通 大黄 黄芩 竹叶 甘草 栀子 淡竹 瞿麦 淡竹叶	小便不通 小便不利 壮热 大便秘结 腹痛 谵语 口渴 慢惊 咽肿 头痛
杏 杏仁 麻黄 苦杏仁 紫苏子 紫苏叶 葶苈子 紫菀 人参 大黄	咳嗽 恶寒 气喘 无汗 耳聋 头痛 浮肿 痫 胸闷 恶寒发热
附子 龙骨 牡蛎 干姜 白矾 赤石脂 硫黄 当归 赭石 禹余粮	盗汗 赤白带 白带 崩中 痫 自汗 脱肛 漏下 头晕 崩漏
当归 阿胶 白芍 艾叶 地榆 芍药 川芎 蒲黄 黄芩 续断	吐血 便血 腹痛 赤白带 白带 崩漏 胎动不安 胎漏 尿血 心烦
茯苓 白术 甘草 人参 半夏 大黄 白薇 当归 白芍 芍药	少气 腹痛 腹满 干呕 呕吐 小便不利 自汗 咳嗽 气喘 舌干
甘草 半夏 茯苓 人参 陈皮 枳实 橘红 枳壳 当归 白术	呕吐 腹满 咳嗽 心下痞 气喘 恶心 噎膈 咽干 反胃 头昏
甘草 人参 茯苓 白术 干姜 当归 柴胡 陈皮 半夏 炙甘草	口噤 腹痛 咳嗽 呕吐 壮热 气喘 自汗 阴疮 角弓反张 口淡
生姜 半夏 厚朴 大枣 桂枝 葱白 小麦 附子 人参 枳实	呕吐 恶寒 头痛 咳嗽 鼻塞 反胃 恶寒发热 臂痛 恶心 脏躁
犀角 车前 车前子 大黄 升麻 黄芩 栀子 羚羊角 钩藤 玄参	壮热 痫 烦躁 心烦 口苦 头痛 咳嗽 小便不利 耳聋 急惊
石膏 葛根 升麻 麻黄 知母 黄芩 柴胡 麦门冬 寒水石 甘草	头痛 壮热 口渴 心烦 咽干 恶寒 谵语 自汗 发狂 牙痛
当归 白芍 川芎 香附 益母草 熟地黄 延胡索 乌药 芍药 牛膝	腹痛 难产 头痛 自汗 盗汗 崩漏 胁痛 嗳气 漏下 吞酸
陈皮 神曲 山楂 麦芽 砂仁 厚朴 香附 苍术 枳实 青皮	恶心 嘈杂 吞酸 腹痛 食欲不振 腹满 大便秘结 嗳气 积滞 呕吐
连翘 荆芥 玄参 薄荷 牛蒡 金银花 桔梗 牛蒡子 升麻 天花粉	瘰疬 麻疹 谵语 丹毒 咳嗽 头痛 痄腮 神昏 咽喉痛 口渴
白芷 川芎 细辛 防风 荆芥 藁本 薄荷 羌活 苍术 蔓荆子	头痛 鼻塞 白带 牙痛 骨痛 麻疹 身重 身痛 无汗 恶寒
甘草 茯苓 人参 白术 当归 陈皮 附子 半夏 白芍 厚朴	干呕 腹痛 消瘦 背痛 短气 咳嗽 呕吐 少气 自汗 气喘
防风 羌活 麻黄 川芎 独活 荆芥 细辛 白芷 苍术 桂枝	头痛 恶寒 无汗 项强 身痛 恶寒发热 浮肿 鼻塞 咳嗽 麻疹
防风 菊花 羌活 藜 荆芥 蒺藜 细辛 苦参 羚羊角 旋覆花	目昏 头痛 流泪 皮肤瘙痒 鼻塞 远视 拳毛倒睫 麻疹 牙痛 身痛
天麻 僵蚕 附子 白附子 全蝎 天南星 麝香 朱砂 蜈蚣 天竺黄	慢惊 痫 半身不遂 头痛 咳嗽 角弓反张 瘰疬 皮肤瘙痒 神昏 四肢抽搐
黄连 青黛 巴豆 麝香 胡黄连 芦荟 使君子 龙胆 皂荚 轻粉	烦躁 疳积 口臭 潮热 心烦 臁疮 痫 盗汗 丹毒 神昏
槟榔 木香 大黄 枳壳 牵牛 郁李 大腹皮 郁李仁 牵牛子 防己	浮肿 腹痛 里急后重 积滞 大便秘结 小便不利 鼻衄 腰痛 腹满 转筋
芍药 赤芍 当归 黄芩 生地黄 细辛 甘草 桂枝 葱白 犀角	鼻衄 四肢疼痛 腹痛 吐血 烦躁 胁痛 舌肿 壮热 小儿口疮 舌卷
甘草 人参 白术 茯苓 半夏 炙甘草 陈皮 桂枝 干姜 附子	恶风 腹痛 头重 咳嗽 口噤 自汗 呕吐 气喘 小便不利 身重
豆蔻 木香 丁香 茴香 肉豆蔻 沉香 胡椒 白豆蔻 诃子 草豆蔻	肠鸣 呕吐 腹痛 腰痛 腹冷 呃逆 吞酸 口臭 恶心 牙痛
桔梗 枳壳 前胡 半夏 甘草 旋覆花 陈皮 葛根 茯苓 瓜蒌	咳嗽 壮热 呕吐 舌苔白 心下痞 胸闷 多唾 反胃 胁痛 气喘
黄芩 黄连 黄柏 栀子 大黄 知母 生地黄 龙胆 甘草 苦参	烦躁 心烦 头痛 盗汗 牙痛 呕吐 咳嗽 口苦 不寐 神昏
桑 山药 党参 熟地黄 黄芪 茯苓 何首乌 桑寄生 莲子 芡实	头晕 白带 心悸 头昏 咽干 目昏 健忘 潮热 浮肿 须发早白
桃 桃仁 当归 红花 丹参 郁金 大黄 川芎 三七 延胡索	腹痛 烦躁 吐血 胸痛 胸闷 崩中 心烦 恶露不下 腰重 发狂
当归 白芍 芍药 牡丹 牡丹皮 川芎 生地黄 熟地黄 延胡索 山茱萸	腹痛 赤白带 吐血 五心烦热 大便下血 消瘦 少气 潮热 头痛 盗汗
麝香 朱砂 牛黄 雄黄 冰片 琥珀 珍珠 天竺黄 蟾酥 硼砂	痫 急惊 神昏 瘰疬 腹痛 难产 发狂 目昏 心烦 谵语
防风 独活 牛膝 羌活 防己 五加 麻黄 木瓜 秦艽 五加皮	口噤 杨梅疮 四肢麻木 转筋 瘫痪 四肢拘急 浮肿 角弓反张 恶寒 半身不遂
桑 紫菀 桑白皮 五味子 款冬花 桔梗 橘红 百部 百合 川贝母	咳嗽 短气 浮肿 气喘 咳血 胸闷 喉痒 自汗 盗汗 咽干
麦冬 知母 玄参 沙参 枇杷 枇杷叶 天冬 竹茹 桔梗 芥子	咳嗽 口渴 咽干 心烦 吐血 潮热 呕吐 咳痰 咳血 瘰疬
甘草 黄芩 柴胡 枳壳 升麻 大黄 芍药 黄连 犀角 葛根	壮热 烦躁 头痛 寒热往来 咳嗽 胁痛 气喘 脱肛 寒战 腹痛
柴胡 地骨皮 鳖甲 知母 甘草 麦门冬 秦艽 青蒿 人参 芍药	潮热 盗汗 寒热往来 心烦 五心烦热 胁痛 咳嗽 口苦 头痛 吐血
干姜 附子 吴茱萸 乌头 细辛 川乌 苦参 大豆 赤小豆 麻黄	呕吐 手足厥冷 面色青 腹冷 腹痛 吞酸 少气 鼻塞 背痛 口噤
陈皮 厚朴 藿香 苍术 半夏 木瓜 香薷 白术 甘草 草果	呕吐 转筋 恶心 恶寒 身重 头痛 腹泻 腹痛 上吐下泻 咳嗽
肉桂 当归 人参 甘草 白术 茯苓 附子 干姜 炮姜 炙甘草	腹痛 浮肿 短气 畏寒 腰痛 头晕 气喘 自汗 不孕 小便不利
