人参 远志 麦门冬 茯苓 五味子 石菖蒲 酸枣仁 甘草 天门冬 柏子仁	耳聋 心烦 少气 健忘 盗汗 不寐 心悸 吐血 舌强 远视
山药 杜仲 菟丝子 牛膝 肉苁蓉 枸杞子 鹿茸 五味子 山茱萸 熟地黄	头晕 心悸 腰痛 盗汗 健忘 小便频数 多梦 食欲不振 头昏 疲乏
芍药 赤芍 甘草 当归 柴胡 黄芩 大黄 升麻 生地黄 羚羊角	壮热 头痛 四肢疼痛 鼻衄 胁痛 寒热往来 烦躁 心烦 丹毒 四肢拘急
当归 桃 桃仁 红花 川芎 丹参 大黄 赤芍 蒲黄 延胡索	腹痛 难产 胸闷 胸痛 胞衣不下 恶露不下 胁痛 闭经 产后腹痛 心悸
生姜 半夏 甘草 厚朴 大枣 人参 竹茹 茯苓 白术 橘红	呕吐 腹满 干呕 恶心 短气 心下痞 小儿呕吐 少气 寒热往来 胁痛
乳香 没药 轻粉 麝香 巴豆 血竭 白芷 雄黄 五灵脂 皂荚	瘰疬 臁疮 无名肿毒 杨梅疮 湿疮 牙痛 粉刺 胎毒 阴疮 带状疱疹
甘草 麻黄 石膏 黄芩 葛根 桂枝 防风 柴胡 葱白 芍药	恶寒 头痛 无汗 恶风 恶寒发热 项强 寒战 腰脊痛 自汗 壮热
附子 天麻 僵蚕 白附子 全蝎 天南星 麝香 朱砂 白矾 蜈蚣	慢惊 口噤 痫 角弓反张 神昏 急惊 舌强 项强 呵欠 四肢强直
桑 麦冬 桔梗 桑白皮 紫菀 知母 百合 五味子 沙参 桑寄生	咳嗽 气喘 吐血 咽干 咳血 遗尿 妊娠咳嗽 自汗 鼻干 阴疮
甘草 茯苓 人参 白术 陈皮 半夏 乌梅 罂粟 罂粟壳 黄连	口苦 舌干 烦躁 咽干 心烦 脱肛 头昏 里急后重 肠鸣 小便黄赤
杏 杏仁 麻黄 桔梗 紫菀 枇杷 枇杷叶 款冬花 橘红 苦杏仁	咳嗽 气喘 咳痰 喉痒 胸闷 心下悸 呕吐 舌肿 咽肿 舌干
槟榔 木香 大黄 三棱 巴豆 莪术 牵牛 青皮 黄连 使君子	腹痛 积滞 腹满 疳积 浮肿 消瘦 口臭 大便秘结 寒热往来 心下痞
当归 白芍 川芎 芍药 牡丹 牡丹皮 熟地黄 香附 生地黄 黄柏	白带 赤白带 崩漏 吐血 不孕 头晕 大便下血 面色青 五心烦热 牙痛
当归 阿胶 龙骨 牡蛎 赤石脂 地榆 艾叶 白芍 黄连 生地黄	吐血 便血 崩中 漏下 鼻衄 脱肛 崩漏 胎漏 尿血 胎动不安
白术 甘草 白芍 当归 茯苓 人参 炙甘草 肉桂 党参 陈皮	腹痛 自汗 胎动不安 畏寒 消瘦 口淡 寒战 口渴 大便溏 盗汗
柴胡 甘草 知母 鳖甲 人参 地骨皮 秦艽 麦门冬 黄芩 枳壳	潮热 心烦 盗汗 五心烦热 寒热往来 但热不寒 少腹痛 低热 痱子 舌肿
防风 菊花 羌活 荆芥 藜 细辛 蒺藜 川芎 白芷 薄荷	目昏 头痛 鼻塞 皮肤瘙痒 流泪 头昏 偏头痛 拳毛倒睫 漏睛 胬肉攀睛
枳壳 半夏 前胡 桔梗 茯苓 甘草 郁李 郁李仁 大腹皮 陈皮	咳嗽 浮肿 气喘 鼻塞 多唾 头痛 壮热 身重 腰重 发狂
陈皮 神曲 厚朴 苍术 山楂 半夏 香附 藿香 麦芽 砂仁	呕吐 恶心 吞酸 嘈杂 嗳气 腹泻 食欲不振 胸闷 反胃 大便溏
干姜 附子 吴茱萸 白术 细辛 肉桂 人参 厚朴 硫黄 当归	腹痛 转筋 腹冷 手足厥冷 面色青 背痛 肠鸣 上吐下泻 口噤 少气
防风 川芎 白芷 羌活 细辛 独活 荆芥 苍术 藁本 麻黄	头痛 鼻塞 身痛 项强 牙痛 恶寒 四肢拘急 头重 身重 流泪
连翘 薄荷 桔梗 荆芥 玄参 牛蒡 天花粉 竹叶 金银花 牛蒡子	口渴 麻疹 丹毒 咽干 烦躁 谵语 胎毒 痄腮 咽肿 小儿丹毒
牛膝 川乌 独活 防风 草乌 木瓜 当归 五加 杜仲 羌活	腰痛 半身不遂 瘫痪 骨痛 四肢麻木 杨梅疮 关节疼痛 背痛 臂痛 足痛
人参 甘草 白术 茯苓 半夏 干姜 黄芩 黄连 艾叶 赤石脂	短气 自汗 恶风 身重 恶寒 头重 盗汗 足热 胁痛 腰重
茯苓 木通 泽泻 滑石 车前 车前子 猪苓 防己 瞿麦 赤小豆	小便不利 小便不通 浮肿 尿血 肥胖 心下痞 妊娠小便不通 骨痛 痱子 头汗
丁香 木香 豆蔻 沉香 肉豆蔻 藿香 砂仁 益智 诃子 白豆蔻	呕吐 恶心 肠鸣 吞酸 反胃 里急后重 口臭 呃逆 腹满 干呕
黄连 黄芩 大黄 栀子 黄柏 茵陈 龙胆 郁金 枳实 苦参	烦躁 谵语 发黄 大便秘结 发狂 心烦 小便黄赤 舌苔黄 牙龈肿痛 舌疮
升麻 石膏 犀角 甘草 麦门冬 黄芩 玄参 栀子 羚羊角 知母	壮热 烦躁 头痛 鼻干 咽喉痛 舌肿 干呕 四肢拘急 口中生疮 谵语
朱砂 麝香 牛黄 雄黄 冰片 青黛 琥珀 天竺黄 钩藤 珍珠	痫 神昏 慢惊 急惊 壮热 牙痛 口臭 弄舌 小儿发热 四肢抽搐
木香 陈皮 枳壳 香附 茴香 乌药 青皮 砂仁 沉香 槟榔	腹痛 里急后重 噎膈 呃逆 胁痛 胃痛 反胃 舌苔白 少腹痛 舌苔白腻
