角色0 ： 薄荷 荷叶 樟脑 荆芥 桔梗 生地黄 大黄 芦根 白及 桉油  角色1 ： 薄荷 桔梗 荆芥 连翘 硫黄 穿山甲 香附 五倍子 黄连 山楂  角色2 ： 薄荷 连翘 荆芥 桔梗 荷叶 旋覆花 天花粉 柴胡 绿豆 地骨皮  角色3 ： 竹叶 淡竹 淡竹叶 连翘 金银花 通草 淡豆豉 天花粉 射干 岗梅	头痛 麻疹 头昏 瘰疬 咳嗽 丹毒 口渴 神昏 鼻干 恶风
角色0 ： 白附子 天南星 天麻 附子 僵蚕 全蝎 诃子 乌梢蛇 巴豆 厚朴  角色1 ： 僵蚕 天麻 全蝎 白附子 蝉蜕 天竺黄 天南星 琥珀 磁石 赤芍  角色2 ： 全蝎 僵蚕 天麻 蜈蚣 朱砂 金银花 紫河车 豆蔻 甜瓜子 莲子  角色3 ： 天南星 白附子 附子 僵蚕 天麻 麝香 牛胆 槐角 雄黄 藿香	慢惊 痫 半身不遂 头痛 咳嗽 瘰疬 角弓反张 皮肤瘙痒 耳聋 急惊
角色0 ： 桃 桃仁 红花 核桃仁 桂枝 大麦 丹参 白薇 小蓟 没药  角色1 ： 桃 桃仁 水蛭 虻虫 泽兰 丹参 五灵脂 阿魏 三七 百草霜  角色2 ： 当归 川芎 红花 牛膝 蒲黄 白芍 益母草 丹参 白术 犀角  角色3 ： 红花 延胡索 苏木 赤芍 泽兰 益母草 丹参 牛膝 刘寄奴 苍术	腹痛 难产 烦躁 胸痛 恶露不下 崩中 漏下 大便秘结 消瘦 谵语
角色0 ： 白术 茯苓 甘草 陈皮 干姜 生姜 竹沥 天麻 当归 青皮  角色1 ： 人参 甘草 柴胡 茯苓 白芍 五倍子 黄连 威灵仙 地骨皮 全蝎  角色2 ： 当归 甘草 白芍 柴胡 苍术 滑石 阿胶 吴茱萸 独活 赤芍  角色3 ： 甘草 茯苓 人参 白术 半夏 滑石 芍药 前胡 细辛 龙骨	背痛 消瘦 腹痛 臂痛 咳嗽 小便不利 呕吐 寒热往来 心悸 壮热
角色0 ： 苍术 厚朴 陈皮 草果 神曲 生姜 甘草 铅丹 小麦 常山  角色1 ： 藿香 香薷 木瓜 广藿香 白扁豆 紫苏叶 檀香 大腹皮 茯苓 砂仁  角色2 ： 厚朴 藿香 陈皮 苍术 砂仁 半夏 茯苓 白矾 商陆 人参  角色3 ： 厚朴 苍术 陈皮 藿香 干姜 法半夏 草果 炙甘草 砂仁 朱砂	呕吐 恶心 转筋 头痛 身重 恶寒 上吐下泻 腹泻 腹痛 食欲不振
角色0 ： 杏 杏仁 苦杏仁 紫苏子 葶苈子 川贝母 山药 枳实 薏苡仁 神曲  角色1 ： 杏仁 杏 麻黄 百部 犀角 知母 桔梗 秦艽 重楼 鳖甲  角色2 ： 杏 杏仁 麻黄 诃子 海螵蛸 白芍 益智仁 法半夏 白芷 牡蛎  角色3 ： 杏仁 杏 苦杏仁 赤芍 桔梗 巴戟天 沉香 麦冬 大黄 桑叶	咳嗽 耳聋 气喘 恶寒 痫 无汗 小便不利 浮肿 胸闷 谵语
角色0 ： 桔梗 甘草 荆芥 连翘 白芷 郁金 白矾 青黛 枳壳 枳实  角色1 ： 白芷 白矾 白蔹 白及 桔梗 五倍子 绿豆 僵蚕 百草霜 诃子  角色2 ： 龙骨 赤石脂 牡蛎 禹余粮 紫石英 硫黄 海螵蛸 石斛 麻黄 白茅根  角色3 ： 牛蒡 牛蒡子 荆芥 连翘 橘红 淡豆豉 桂枝 滑石 白豆蔻 荷叶	咳嗽 白带 瘰疬 盗汗 麻疹 头晕 丹毒 脱肛 痫 吐血
角色0 ： 当归 甘草 人参 防风 橘红 黄芩 细辛 白术 黄连 茵陈  角色1 ： 甘草 半夏 茯苓 芍药 麦门冬 钩藤 防己 枳壳 柴胡 陈皮  角色2 ： 甘草 炙甘草 陈皮 白术 五味子 大豆 五灵脂 诃子 桑寄生 百草霜  角色3 ： 乌梅 罂粟 罂粟壳 诃子 瓜蒌 白矾 羌活 川芎 百合 大黄	腹痛 里急后重 咳嗽 消瘦 气喘 舌干 呕吐 烦躁 舌苔白 脱肛
角色0 ： 紫菀 款冬花 五味子 百合 天门冬 白石英 紫苏子 蛤蚧 百部 防己  角色1 ： 桑 桑白皮 五味子 紫苏叶 葶苈子 紫苏子 川贝母 雄黄 商陆 补骨脂  角色2 ： 桑 桑白皮 桑叶 桔梗 地骨皮 葶苈子 桑枝 小蓟 旋覆花 栀子  角色3 ： 紫菀 百部 款冬花 百合 白前 马兜铃 桑 五味子 旋覆花 贯众	咳嗽 短气 浮肿 气喘 咽干 咳血 头晕 盗汗 口渴 小便不利
角色0 ： 甘草 人参 当归 川芎 半夏 白术 桔梗 牛膝 白附子 小麦  角色1 ： 甘草 半夏 茯苓 人参 白术 柴胡 麝香 芍药 生姜 枳壳  角色2 ： 茯苓 白术 当归 人参 地骨皮 半夏 五味子 陈皮 阿胶 泽泻  角色3 ： 甘草 人参 当归 桔梗 黄连 柴胡 白矾 茯苓 太子参 蛇床子	腹痛 恶风 咽干 咳嗽 气喘 短气 舌强 呕吐 腹满 恶寒
角色0 ： 山药 熟地黄 五味子 山茱萸 枸杞子 磁石 泽泻 菟丝子 附子 楮实子  角色1 ： 远志 五味子 石菖蒲 酸枣仁 蛤蚧 玉竹 生地黄 桑寄生 蜈蚣 丹参  角色2 ： 远志 酸枣仁 柏子仁 紫石英 龙齿 五味子 石菖蒲 麦门冬 鹿茸 琥珀  角色3 ： 远志 五味子 柏子仁 丹参 石菖蒲 酸枣仁 麦门冬 熟地黄 泽兰 当归	健忘 耳聋 盗汗 短气 痫 自汗 多梦 心悸 头晕 咳嗽
角色0 ： 巴豆 皂荚 猪牙皂 巴豆霜 斑蝥 甘遂 川芎 五灵脂 丹参 羌活  角色1 ： 牵牛 槟榔 牵牛子 萝卜 前胡 厚朴 阿魏 猪牙皂 朱砂 贯众  角色2 ： 大黄 巴豆 木香 槟榔 白矾 绿豆 金银花 大戟 狗脊 斑蝥  角色3 ： 大黄 枳实 木香 赤小豆 皂荚 槟榔 柴胡 五灵脂 硫黄 芒硝	腹满 积滞 腹痛 大便秘结 瘰疬 里急后重 口噤 痫 小便不通 咽肿
角色0 ： 朱砂 麝香 牛黄 赭石 雄黄 代赭石 犀角 郁金 梅花 忍冬藤  角色1 ： 琥珀 天竺黄 牛黄 冰片 珍珠 钩藤 胆南星 水牛角 玳瑁 郁金  角色2 ： 朱砂 麝香 牛黄 雄黄 牛胆 天竺黄 钩藤 诃子 胆南星 贯众  角色3 ： 麝香 牛黄 雄黄 朱砂 冰片 天麻 大戟 小麦 麦门冬 钩藤	痫 急惊 神昏 发狂 瘰疬 目昏 腹痛 心烦 四肢抽搐 谵语
角色0 ： 麦门冬 知母 天门冬 生地黄 羚羊角 犀角 玄参 柴胡 人参 附子  角色1 ： 甘草 人参 茯苓 白芍 川芎 五味子 羚羊角 知母 花椒 薄荷  角色2 ： 麦门冬 生地黄 天门冬 五味子 知母 百草霜 黄柏 乌梅 白芍 香附  角色3 ： 麦门冬 地骨皮 人参 茯苓 升麻 橘红 五味子 玄参 肉桂 葶苈子	心烦 咳嗽 潮热 五心烦热 短气 吐血 盗汗 口渴 气喘 便血
角色0 ： 白芷 川芎 防风 细辛 藁本 苍术 前胡 香附 卷柏 紫菀  角色1 ： 防风 羌活 藁本 细辛 荆芥 川芎 蔓荆子 独活 白芷 硼砂  角色2 ： 白芷 川芎 细辛 藁本 蔓荆子 薄荷 防风 当归 苦参 白芍  角色3 ： 川芎 白芷 细辛 羌活 丁香 柴胡 白附子 槟榔 石膏 桑	头痛 鼻塞 白带 牙痛 骨痛 身痛 无汗 偏头痛 浮肿 恶风
角色0 ： 黄芩 柴胡 枳壳 黄柏 枳实 麦门冬 黄连 甘草 紫草 蒲黄  角色1 ： 甘草 柴胡 枳壳 大黄 麦门冬 生地黄 琥珀 猪牙皂 五味子 白薇  角色2 ： 黄芩 大黄 陈皮 白芍 栀子 升麻 甘草 犀角 麻黄 生地黄  角色3 ： 甘草 柴胡 黄芩 葛根 芍药 栀子 薄荷 青蒿 狗脊 防己	壮热 头痛 咳嗽 头重 寒热往来 烦躁 腹痛 目昏 鼻衄 恶寒
角色0 ： 芥子 白芥 白芥子 白术 陈皮 半夏 甘草 郁金 青礞石 栀子  角色1 ： 人参 甘草 半夏 枳壳 橘红 竹沥 木香 川贝母 黄连 人中白  角色2 ： 半夏 枳实 陈皮 白芍 橘红 枳壳 茯苓 厚朴 香附 浙贝母  角色3 ： 茯苓 甘草 半夏 附子 白术 干姜 赤芍 桑枝 蒲公英 大腹皮	呕吐 腹满 咳嗽 口淡 恶心 大便秘结 反胃 壮热 肠鸣 嘈杂
角色0 ： 乳香 没药 五灵脂 地龙 木鳖子 骨碎补 自然铜 虎骨 狗脊 独活  角色1 ： 川乌 草乌 乌头 威灵仙 何首乌 赤小豆 制川乌 苍术 地龙 天南星  角色2 ： 白芷 川芎 苍术 乌药 麻黄 五灵脂 白术 法半夏 当归 桂枝  角色3 ： 川乌 乌头 草乌 两头尖 天南星 天葵 川贝母 菊花 郁金 樟脑	瘫痪 半身不遂 骨痛 口噤 身重 腰痛 白带 瘰疬 关节疼痛 鼻塞
角色0 ： 升麻 犀角 羚羊角 玄参 黄芩 蔓荆子 射干 栀子 安息香 五倍子  角色1 ： 犀角 升麻 龙齿 钩藤 蛇蜕 羚羊角 白鲜皮 蜂房 桂枝 黄芩  角色2 ： 升麻 犀角 玄参 射干 连翘 麻黄根 天麻 巴豆 麻黄 高良姜  角色3 ： 连翘 黄芩 升麻 夏枯草 射干 海藻 昆布 漏芦 玄参 荆芥	瘰疬 痫 咽喉痛 壮热 头痛 舌肿 脱肛 麻疹 弄舌 口臭
角色0 ： 生姜 厚朴 葱白 大枣 白矾 黄连 艾叶 陈皮 炙甘草 桂枝  角色1 ： 生姜 大枣 半夏 小麦 陈皮 鸡子 白矾 甘草 石菖蒲 桑叶  角色2 ： 生姜 厚朴 半夏 泽兰 芜荑 竹沥 乌梅 草果 五味子 柏子仁  角色3 ： 生姜 半夏 枳实 厚朴 白矾 滑石 附子 皂角刺 橘红 贯众	呕吐 恶寒 头痛 咳嗽 鼻塞 恶寒发热 脏躁 舌苔黄 小儿呕吐 腹痛
角色0 ： 当归 肉桂 人参 川芎 白术 细辛 麻黄 蜗牛 青皮 蒲黄  角色1 ： 白术 肉桂 干姜 山药 木香 炮姜 枳实 香附 柏子仁 浙贝母  角色2 ： 附子 干姜 肉桂 吴茱萸 升麻 砂仁 秦艽 琥珀 蜂蜜 延胡索  角色3 ： 肉桂 附子 人参 干姜 半夏 皂荚 川芎 浮萍 麝香 白术	浮肿 腹痛 短气 畏寒 腰痛 头晕 气喘 呕吐 腹冷 恶心
角色0 ： 甘草 白术 当归 炙甘草 茯苓 白芍 生地黄 赤小豆 枳壳 细辛  角色1 ： 甘草 人参 茯苓 半夏 升麻 枳壳 白芍 冰片 大枣 乌梅  角色2 ： 人参 当归 茯苓 犀角 半夏 羚羊角 陈皮 赤芍 天门冬 苍术  角色3 ： 甘草 炙甘草 芍药 五味子 白术 大黄 薄荷 荆芥 三七 硫黄	腹痛 壮热 口苦 咳嗽 恶风 鼻干 气喘 舌干 自汗 咽干
角色0 ： 川芎 当归 白芍 白芷 芍药 生地黄 鹿茸 葛根 青蒿 槟榔  角色1 ： 芍药 当归 白芍 生姜 白薇 木香 桑 肉桂 乌梅 枳壳  角色2 ： 白芍 当归 川芎 炮姜 天麻 硫黄 蛇蜕 磁石 杏仁 黄柏  角色3 ： 当归 白芍 川芎 炙甘草 红花 砂仁 熟地黄 硫黄 丹参 乌梅	腹痛 头痛 自汗 盗汗 胁痛 崩漏 恶风 恶心 大便下血 赤白带
角色0 ： 羌活 防风 独活 荆芥 菊花 麻黄 细辛 川芎 天麻 桔梗  角色1 ： 防风 羌活 细辛 独活 荆芥 香附 薄荷 蛇蜕 黄连 地龙  角色2 ： 菊花 木贼 石决明 决明子 青葙子 青葙 蝉蜕 地肤子 枸杞子 野菊花  角色3 ： 防风 羚羊角 菊花 羌活 人参 冰片 荆芥 犀角 木通 钩藤	目昏 头痛 流泪 无汗 身痛 鼻塞 浮肿 拳毛倒睫 发狂 痫
角色0 ： 白芷 苦参 荆芥 苍耳 薄荷 苍耳子 独活 菊花 辛夷 附子  角色1 ： 防风 羌活 荆芥 细辛 巴豆 防己 麦冬 佛手 蔓荆子 槟榔  角色2 ： 防风 荆芥 羌活 独活 川芎 前胡 薄荷 赤芍 桑枝 蝉蜕  角色3 ： 藜 蒺藜 藜芦 苦参 瓜蒂 白薇 干姜 斑蝥 黄连 夏枯草	头痛 鼻塞 皮肤瘙痒 麻疹 身痛 白带 目昏 无汗 项强 赤白带
角色0 ： 黄芩 甘草 当归 枳壳 白芷 升麻 羌活 青黛 石膏 川芎  角色1 ： 甘草 枳壳 大黄 茯苓 郁金 陈皮 升麻 栀子 半夏 桑  角色2 ： 甘草 大黄 茯苓 白术 槟榔 麦门冬 桔梗 薄荷 苍术 黄连  角色3 ： 甘草 黄连 桔梗 黄芩 当归 大黄 荆芥 白芍 槟榔 蕤仁	烦躁 咳嗽 腹痛 气喘 壮热 头痛 大便秘结 呕吐 舌干 手足厥冷
角色0 ： 乳香 没药 血竭 轻粉 儿茶 冰片 象皮 麝香 蜈蚣 巴豆  角色1 ： 雄黄 麝香 轻粉 朱砂 蟾酥 蜈蚣 五倍子 樟脑 细辛 胆矾  角色2 ： 乳香 没药 穿山甲 蓖麻 松香 蓖麻子 轻粉 血竭 木鳖子 樟脑  角色3 ： 冰片 硼砂 麝香 珍珠 轻粉 儿茶 炉甘石 玄明粉 熊胆 海螵蛸	无名肿毒 臁疮 瘰疬 杨梅疮 神昏 痫 心烦 胬肉攀睛 腹痛 赤白带
角色0 ： 木香 沉香 附子 丁香 安息香 茯苓 白术 母丁香 青皮 五灵脂  角色1 ： 木香 槟榔 青皮 青木香 莱菔子 乌药 阳起石 肉桂 水牛角 阿魏  角色2 ： 丁香 木香 沉香 檀香 母丁香 诃子 橘红 蟾酥 麝香 牛黄  角色3 ： 木香 丁香 沉香 茴香 高良姜 陈皮 藿香 胡椒 青皮 秦艽	腹痛 呕吐 呃逆 里急后重 噎膈 小儿呕吐 腹冷 胃痛 头重 带状疱疹
角色0 ： 甘草 人参 白术 半夏 橘红 木通 五味子 桔梗 当归 龙胆  角色1 ： 茯苓 甘草 人参 麦门冬 葛根 桂枝 陈皮 白鲜皮 当归 常山  角色2 ： 茯苓 半夏 陈皮 炙甘草 人参 赤小豆 丁香 草果 菟丝子 茴香  角色3 ： 甘草 白术 半夏 桔梗 枳壳 泽泻 黄柏 前胡 黄芩 竹叶	恶风 呕吐 项强 咳嗽 气喘 腹痛 反胃 短气 小便不利 头痛
角色0 ： 白术 附子 人参 甘草 木香 枳壳 前胡 黄芩 黄柏 麝香  角色1 ： 甘草 人参 枳壳 防风 冬瓜 陈皮 砂仁 高良姜 石膏 川芎  角色2 ： 甘草 茯苓 丹参 泽泻 白术 蜂房 牡蛎 枳壳 熟地黄 雄黄  角色3 ： 人参 茯苓 陈皮 麦门冬 麦冬 吴茱萸 附子 芍药 当归 枳壳	壮热 少气 咳嗽 舌干 气喘 腹痛 慢惊 肠鸣 自汗 舌强
角色0 ： 连翘 金银花 天花粉 玄参 蝉蜕 板蓝根 紫草 蒲公英 大青叶 天竺黄  角色1 ： 大黄 黄芩 当归 栀子 麦门冬 黄柏 陈皮 茯苓 白薇 香附  角色2 ： 黄芩 郁金 黄连 甘草 栀子 枳壳 紫草 木通 磁石 细辛  角色3 ： 黄芩 甘草 大黄 赤芍 黄连 柴胡 桔梗 五味子 羚羊角 僵蚕	谵语 烦躁 头痛 咳嗽 神昏 吐血 丹毒 口渴 舌苔黄 麻疹
角色0 ： 牡丹 牡丹皮 茯苓 黄柏 香附 甘草 大黄 莲子心 高良姜 蝉蜕  角色1 ： 芍药 生地黄 当归 川芎 升麻 苍术 熟地黄 干漆 藕节 龙齿  角色2 ： 芍药 赤芍 生地黄 当归 白矾 荆芥 川芎 吴茱萸 羌活 黄连  角色3 ： 芍药 当归 赤芍 白芍 乌梅 升麻 玄参 莱菔子 干姜 川芎	鼻衄 吐血 崩中 腹痛 腰重 五心烦热 潮热 咽干 咳血 短气
角色0 ： 阿胶 艾叶 地榆 续断 蒲黄 槐角 豆蔻 山茱萸 香橼 菟丝子  角色1 ： 鹿角 鹿角胶 当归 白芍 杜仲 鹿角霜 五味子 续断 艾叶 茜草  角色2 ： 当归 阿胶 白芍 川芎 艾叶 地榆 山药 郁金 百合 细辛  角色3 ： 蒲黄 阿胶 地榆 当归 槐花 小蓟 侧柏叶 赤石脂 艾叶 丹参	吐血 白带 便血 赤白带 崩漏 腹痛 胎漏 尿血 胎动不安 咳嗽
角色0 ： 党参 黄芪 丹参 三七 山药 益母草 熟地黄 枸杞子 茜草 柴胡  角色1 ： 桑 桑寄生 桑螵蛸 续断 桑叶 郁金 薤白 鹿茸 独活 木香  角色2 ： 山药 党参 芡实 莲子 龙眼肉 龙眼 薏苡仁 莲须 莲子心 白扁豆  角色3 ： 何首乌 女贞 女贞子 熟地黄 枸杞子 菟丝子 黄精 制何首乌 金樱子 黄芪	头晕 白带 心悸 头昏 目昏 烦躁 浮肿 健忘 须发早白 自汗
角色0 ： 山楂 神曲 麦芽 枳实 莱菔子 陈皮 青皮 砂仁 茵陈 大豆  角色1 ： 陈皮 砂仁 香附 青皮 厚朴 谷芽 山药 草果 乌药 萝卜  角色2 ： 神曲 麦芽 山楂 鸡内金 谷芽 党参 厚朴 槟榔 苍术 淡豆豉  角色3 ： 厚朴 陈皮 苍术 神曲 香附 山楂 枳实 白术 枳壳 青皮	恶心 嘈杂 食欲不振 吞酸 积滞 腹痛 腹满 腹泻 嗳气 口臭
角色0 ： 麻黄 防风 羌活 独活 细辛 三七 芍药 地骨皮 桂枝 蜂房  角色1 ： 麻黄 桂枝 甘草 陈皮 半夏 防己 麻黄根 厚朴 当归 泽泻  角色2 ： 麻黄 防风 细辛 附子 五味子 白术 羚羊角 丁香 续断 皂荚  角色3 ： 麻黄 桂枝 甘草 附子 羌活 白果 防己 白芷 铅丹 朱砂	恶寒 头痛 无汗 浮肿 气喘 恶寒发热 咳嗽 胸闷 鼻塞 小便不利
角色0 ： 石膏 葛根 知母 升麻 麦门冬 栀子 大青叶 荆芥 大黄 川贝母  角色1 ： 石膏 葛根 麻黄 木香 黄芩 神曲 雷丸 昆布 黄芪 龙骨  角色2 ： 石膏 寒水石 升麻 知母 葛根 黄芩 芍药 甘草 龙齿 郁金  角色3 ： 石膏 葛根 知母 升麻 黄芩 麻黄 小麦 半夏 芍药 橘核	头痛 壮热 口渴 咽干 心烦 谵语 牙痛 自汗 神昏 发狂
角色0 ： 柴胡 鳖甲 知母 地骨皮 秦艽 常山 远志 玄参 天门冬 瓜蒂  角色1 ： 知母 柴胡 地骨皮 鳖甲 秦艽 黄芩 山药 黄柏 吴茱萸 常山  角色2 ： 柴胡 甘草 人参 黄芩 黄连 秦艽 茯苓 吴茱萸 黄柏 竹沥  角色3 ： 柴胡 鳖甲 青蒿 秦艽 知母 常山 银柴胡 五味子 紫苏叶 安息香	潮热 寒热往来 盗汗 五心烦热 头痛 胁痛 咳嗽 但热不寒 烦躁 气喘
角色0 ： 茯苓 白术 泽泻 陈皮 附子 人参 桂枝 生姜 白矾 商陆  角色1 ： 泽泻 茯苓 猪苓 白术 苍术 木通 大麦 细辛 附子 紫河车  角色2 ： 茯苓 白术 甘草 山药 柴胡 桂枝 草果 高良姜 葛根 陈皮  角色3 ： 泽泻 猪苓 木通 柴胡 茯苓 栀子 防己 鸡子 樟脑 轻粉	小便不利 呕吐 小便黄赤 心下痞 大便下血 发黄 自汗 白带 腹痛 小便频数
角色0 ： 黄连 黄芩 栀子 柴胡 甘草 枳实 大黄 黄柏 龙胆 防风  角色1 ： 黄连 黄柏 黄芩 桂枝 犀角 蜂房 乌药 三七 羚羊角 紫苏叶  角色2 ： 黄连 黄柏 当归 生地黄 知母 木通 栀子 犀角 生姜 甘草  角色3 ： 大黄 黄连 黄芩 黄柏 栀子 葶苈子 大豆 木瓜 菊花 桔梗	烦躁 心烦 不寐 吞酸 呕吐 盗汗 牙痛 神昏 胸闷 唇肿
角色0 ： 白术 甘草 茯苓 当归 芍药 白芷 知母 枳壳 白薇 何首乌  角色1 ： 茯苓 白术 当归 芍药 生地黄 酸枣仁 白芍 牛膝 五味子 山药  角色2 ： 人参 白术 当归 茯苓 赤石脂 天麻 半夏 石斛 甘草 轻粉  角色3 ： 人参 白术 甘草 茯苓 阿胶 麦门冬 五味子 川贝母 吴茱萸 薄荷	少气 腹痛 自汗 小便不利 慢惊 烦躁 呕吐 短气 咳嗽 大便溏
角色0 ： 干姜 附子 吴茱萸 细辛 乌药 槐角 槟榔 芡实 高良姜 白芷  角色1 ： 干姜 附子 吴茱萸 半夏 厚朴 乌头 高良姜 肉桂 大黄 泽兰  角色2 ： 干姜 附子 硫黄 吴茱萸 白术 生姜 阳起石 当归 厚朴 黄芩  角色3 ： 吴茱萸 干姜 附子 龙骨 当归 硫黄 延胡索 法半夏 旋覆花 萝卜	呕吐 手足厥冷 面色青 腹冷 腹痛 吞酸 干呕 赤白带 头痛 小儿腹痛
角色0 ： 附子 干姜 乌头 吴茱萸 神曲 独活 钩藤 知母 肉桂 旋覆花  角色1 ： 防风 当归 人参 干姜 白术 麻黄 丹参 甘草 钩藤 秦艽  角色2 ： 附子 细辛 干姜 防风 甘草 芍药 茯苓 黄芩 泽泻 独活  角色3 ： 附子 人参 干姜 细辛 防风 炙甘草 竹沥 前胡 磁石 芍药	口噤 角弓反张 项强 鼻塞 呕吐 头痛 腹冷 牙痛 自汗 恶寒
角色0 ： 陈皮 茯苓 厚朴 甘草 半夏 附子 枳实 瓜蒌 细辛 青皮  角色1 ： 半夏 陈皮 茯苓 枳壳 枳实 黄连 瓜蒌 麻黄 砂仁 黄芩  角色2 ： 甘草 人参 白术 半夏 茯苓 苍术 桔梗 升麻 鹿茸 芍药  角色3 ： 甘草 茯苓 半夏 防风 黄芩 枳壳 枳实 滑石 生姜 犀角	呕吐 恶心 咳嗽 鼻衄 恶寒 反胃 头痛 气喘 耳聋 寒战
角色0 ： 三棱 莪术 巴豆 干漆 芫花 五灵脂 当归 香附 使君子 姜黄  角色1 ： 茴香 小茴香 川楝子 葫芦 补骨脂 胡芦巴 木香 郁金 八角茴香 橘核  角色2 ： 木香 青皮 延胡索 沉香 槟榔 大腹皮 青礞石 枳实 桂枝 三七  角色3 ： 三棱 莪术 青皮 槟榔 阿魏 枳实 干姜 橘红 大麦 藿香	腹痛 赤白带 腰痛 恶心 消瘦 里急后重 腹冷 胸闷 心下痞 烦躁
角色0 ： 当归 川芎 白芍 枳壳 牡蛎 杜仲 细辛 全蝎 竹沥 木贼  角色1 ： 白芍 当归 川芎 益母草 芍药 琥珀 熟地黄 艾叶 白矾 防己  角色2 ： 白芍 川芎 当归 熟地黄 香附 肉桂 细辛 柴胡 黄连 附子  角色3 ： 川芎 白芍 香附 当归 熟地黄 白术 延胡索 白芷 大黄 龙胆	腹痛 头痛 盗汗 赤白带 自汗 崩漏 难产 目昏 漏下 吞酸
角色0 ： 竹茹 麦门冬 芦根 葱白 白芍 桔梗 葛根 山药 知母 陈皮  角色1 ： 半夏 茯苓 人参 麦门冬 当归 桔梗 柴胡 橘红 知母 牛膝  角色2 ： 甘草 茯苓 人参 半夏 当归 大黄 干姜 枳壳 白芍 桑  角色3 ： 甘草 人参 白术 茯苓 柴胡 大枣 枳实 防风 麦门冬 五味子	干呕 呕吐 吐血 心烦 壮热 舌强 咳嗽 腹痛 短气 反胃
角色0 ： 芍药 赤芍 当归 干姜 木瓜 薄荷 肉桂 升麻 葶苈子 牛膝  角色1 ： 芍药 赤芍 当归 川芎 磁石 郁金 羚羊角 枳实 延胡索 地骨皮  角色2 ： 芍药 赤芍 甘草 当归 枳壳 防己 木通 赤小豆 远志 龙胆  角色3 ： 芍药 赤芍 柴胡 大黄 羚羊角 葛根 黄芩 陈皮 细辛 麻黄	壮热 四肢疼痛 腹痛 吐血 胁痛 耳聋 头晕 转筋 粉刺 阴疮
角色0 ： 郁李仁 郁李 甘遂 防己 大戟 芫花 牵牛 泽漆 百合 椒目  角色1 ： 槟榔 枳壳 木香 青皮 桔梗 牡蛎 白茅根 苍术 木通 青礞石  角色2 ： 槟榔 枳壳 木香 香附 白矾 川芎 紫苏子 旋覆花 蒲公英 三七  角色3 ： 木通 大腹皮 桑 防己 槟榔 磁石 木香 半夏 干姜 桂枝	浮肿 里急后重 腹痛 小便不利 小便不通 积滞 耳聋 脱肛 瘰疬 腹满
角色0 ： 玄参 桔梗 麦冬 天花粉 知母 浙贝母 山豆根 天冬 石膏 山茱萸  角色1 ： 麦冬 沙参 北沙参 百合 石斛 玄参 川贝母 天冬 南沙参 知母  角色2 ： 麦冬 天冬 玄参 知母 郁金 竹叶 荆芥 马兜铃 山药 马勃  角色3 ： 橘红 瓜蒌 麦冬 桔梗 川贝母 法半夏 化橘红 梨 当归 瓜蒌皮	口渴 咳嗽 咽干 心烦 喉痒 瘰疬 潮热 壮热 舌疮 大便秘结
角色0 ： 牛膝 木瓜 秦艽 独活 红花 续断 狗脊 桂枝 杜仲 威灵仙  角色1 ： 独活 羌活 防风 秦艽 麻黄 天麻 石膏 萝卜 竹沥 蝉蜕  角色2 ： 五加 五加皮 牛膝 薏苡仁 独活 海桐皮 丹参 当归 骨碎补 杜仲  角色3 ： 防风 防己 白鲜皮 土茯苓 木瓜 薏苡仁 牛膝 金银花 威灵仙 皂角刺	转筋 杨梅疮 四肢麻木 四肢拘急 腰痛 半身不遂 浮肿 面色青 足痛 腹痛
角色0 ： 黄连 青黛 胡黄连 熊胆 芦荟 麝香 龙胆 瓜蒂 使君子 郁金  角色1 ： 麝香 朱砂 雄黄 牛黄 蟾酥 青黛 葱白 樟脑 蜗牛 乌头  角色2 ： 麝香 青黛 朱砂 白矾 雄黄 黄连 轻粉 人中白 硼砂 乌梅  角色3 ： 黄连 使君子 胡黄连 芦荟 芜荑 雷丸 鹤虱 夜明砂 龙胆 黄柏	疳积 烦躁 痫 潮热 瘰疬 心烦 腹痛 盗汗 急惊 神昏
角色0 ： 滑石 木通 瞿麦 冬葵 冬葵子 石韦 通草 猪苓 白芷 王不留行  角色1 ： 牡蛎 龙骨 石榴 赤石脂 石榴皮 麻黄根 石膏 寒水石 当归 沉香  角色2 ： 车前 车前子 车前草 木通 黄连 芍药 磁石 茺蔚子 雄黄 菟丝子  角色3 ： 木通 滑石 瞿麦 黄芩 海金沙 苍术 紫河车 青蒿 海螵蛸 紫草	小便不通 盗汗 小便不利 自汗 瘰疬 头晕 吞酸 赤白带 尿血 湿疮
角色0 ： 人参 茯苓 白术 半夏 甘草 苍术 丹参 蝉蜕 陈皮 生地黄  角色1 ： 茯苓 白术 半夏 甘草 黄连 柴胡 生姜 砂仁 五味子 麦门冬  角色2 ： 白术 人参 柴胡 枳实 龙胆 附子 黄连 白茅根 鳖甲 当归  角色3 ： 甘草 当归 茯苓 枳壳 肉桂 人参 黄柏 赤芍 忍冬藤 麻黄	腹满 腹痛 呕吐 口苦 小便不利 短气 自汗 壮热 噎膈 气喘
角色0 ： 杜仲 牛膝 续断 补骨脂 鹿茸 黄柏 胡芦巴 肉苁蓉 磁石 茵陈  角色1 ： 菟丝子 鹿茸 肉苁蓉 蛇床子 枸杞子 覆盆子 补骨脂 五味子 淫羊藿 巴戟天  角色2 ： 肉苁蓉 山茱萸 牛膝 杜仲 菟丝子 石斛 巴戟天 鹿茸 磁石 桑螵蛸  角色3 ： 枇杷 枇杷叶 石斛 牛膝 杜仲 狗脊 莪术 枸杞子 橘红 巴戟天	腰痛 目昏 耳聋 不孕 头晕 小便频数 腰膝无力 胎动不安 远视 胞衣不下
角色0 ： 豆蔻 益智 益智仁 草豆蔻 肉豆蔻 高良姜 白豆蔻 诃子 樟脑 黄芩  角色1 ： 丁香 沉香 藿香 甘松 檀香 木香 零陵香 松香 豆蔻 茴香  角色2 ： 豆蔻 肉豆蔻 白豆蔻 诃子 草豆蔻 草果 赤石脂 丁香 知母 蜂房  角色3 ： 丁香 胡椒 木香 高良姜 荜茇 荜澄茄 诃子 萝卜 防己 青皮	呕吐 肠鸣 口臭 腹痛 小便频数 呃逆 遗尿 吞酸 胸闷 腹冷
角色0 ： 枳壳 前胡 旋覆花 甘草 半夏 大黄 桔梗 法半夏 紫苏叶 蝉蜕  角色1 ： 前胡 桔梗 枳壳 半夏 紫苏叶 甘草 橘红 白芷 连翘 犀角  角色2 ： 桔梗 前胡 枳壳 大腹皮 半夏 黄柏 人参 木香 茯苓 山楂  角色3 ： 桔梗 枳壳 前胡 茯苓 紫苏叶 大腹皮 荆芥 饴糖 玉竹 珍珠母	咳嗽 壮热 胁痛 胸闷 多唾 脱肛 浮肿 咽干 心下痞 粉刺
角色0 ： 大黄 柴胡 栀子 龙胆 黄芩 枳壳 郁金 升麻 生地黄 石榴  角色1 ： 黄芩 大黄 栀子 黄柏 桔梗 苦参 瓜蒂 升麻 木香 山药  角色2 ： 栀子 茵陈 黄芩 升麻 龙胆 茵陈蒿 黄连 乌梅 木通 丁香  角色3 ： 黄芩 黄连 栀子 黄柏 羚羊角 姜黄 麦冬 冬瓜 赤芍 羌活	发黄 头痛 口苦 心烦 烦躁 耳聋 咳嗽 胁痛 壮热 胸闷
角色0 ： 香附 砂仁 姜黄 川芎 枳壳 乌药 黄连 片姜黄 神曲 琥珀  角色1 ： 香附 陈皮 乌药 砂仁 青皮 川芎 木香 当归 佛手 生姜  角色2 ： 香附 陈皮 砂仁 木香 青皮 乌药 藿香 萝卜 郁金 黄连  角色3 ： 香附 陈皮 砂仁 木香 乌药 川芎 青皮 朱砂 荆芥 葱白	恶心 腹痛 吞酸 呕吐 嗳气 胎动不安 咳嗽 急惊 经行腹痛 胁痛
角色0 ： 甘草 半夏 茯苓 黄芩 川芎 柴胡 绿豆 黄柏 羌活 旋覆花  角色1 ： 茯苓 人参 甘草 当归 半夏 附子 黄芩 黄连 白芍 犀角  角色2 ： 人参 茯苓 甘草 桔梗 郁金 延胡索 前胡 百草霜 大枣 生地黄  角色3 ： 甘草 白术 麦门冬 人参 当归 知母 羚羊角 山药 枳实 炙甘草	舌干 口苦 咳嗽 腹痛 呕吐 小便不利 气喘 潮热 四肢拘急 心烦
