甘草 茯苓 当归 人参 白术 黄芩 柴胡 陈皮 川芎 半夏	呕吐 恶心 腹痛 肠鸣 干呕 手足厥冷 头昏 慢惊 咳痰 转筋
甘草 茯苓 人参 当归 白术 黄芩 陈皮 半夏 五味子 川芎	头晕 心烦 健忘 心悸 头昏 不寐 烦躁 盗汗 自汗 胸闷
甘草 人参 茯苓 黄芩 当归 白术 半夏 柴胡 芍药 陈皮	口苦 舌干 寒热往来 咽干 心烦 耳聋 胁痛 小便黄赤 但热不寒 小便浑浊
甘草 茯苓 当归 人参 白术 川芎 陈皮 木香 黄连 附子	腹痛 小便不通 瘰疬 脱肛 疳积 里急后重 腰痛 鼻痒 阴疮 不射精
甘草 当归 茯苓 人参 黄芩 白术 川芎 白芍 芍药 黄连	吐血 便血 鼻衄 咳血 尿血 大便下血 月经过多 汗血 血精 舌上出血
甘草 茯苓 当归 人参 白术 黄芩 半夏 陈皮 芍药 柴胡	头痛 咳嗽 壮热 鼻塞 面色红 鼻痛 小儿抽动 急惊 恶风 胎水肿满
甘草 当归 茯苓 黄芩 防风 川芎 人参 大黄 芍药 白术	目昏 流泪 皮肤瘙痒 牙痛 舌肿 胬肉攀睛 粉刺 拳毛倒睫 远视 目干涩
甘草 茯苓 人参 白术 当归 陈皮 半夏 木香 黄芩 桔梗	咳嗽 气喘 咳痰 喉痒 妊娠咳嗽 背冷 顿咳 哮鸣 舌青 脱肛
甘草 当归 茯苓 川芎 人参 白术 芍药 陈皮 白芍 木香	浮肿 漏下 难产 崩中 胞衣不下 恶露不下 腹痛 目昏 臂痛 胎漏
甘草 当归 人参 茯苓 黄芩 防风 川芎 麝香 半夏 白术	痫 慢惊 急惊 杨梅疮 湿疮 弄舌 头热 四肢抽搐 天疱疮 壮热
甘草 茯苓 当归 人参 白术 白芍 陈皮 川芎 大黄 半夏	吞酸 嘈杂 呕吐 嗳气 呃逆 恶心 胃痛 食欲不振 胁痛 四肢抽搐
甘草 当归 人参 茯苓 白术 川芎 陈皮 黄芩 半夏 附子	痫 慢惊 神昏 壮热 发黄 口流涎 晕厥 小儿发黄 红疹 发狂
甘草 人参 茯苓 当归 白术 附子 半夏 防风 柴胡 黄芩	短气 少气 目昏 背痛 恶风 项强 耳聋 头重 腰重 足颤
甘草 茯苓 当归 人参 芍药 黄芩 木香 白术 川芎 柴胡	腹痛 胎动不安 胁痛 腰痛 崩漏 产后腹痛 少腹痛 耳聋 阴痒 腰重
甘草 茯苓 人参 当归 白术 附子 半夏 厚朴 木香 黄芩	腹满 小便不利 浮肿 身重 心下痞 大便溏 小便不通 口淡 足热 发黄
甘草 茯苓 当归 人参 白术 白芍 黄连 黄芩 川芎 芍药	心烦 五心烦热 盗汗 潮热 消瘦 咽喉痛 独语 善悲 妊娠心烦 善怒
甘草 茯苓 当归 人参 半夏 白术 防风 陈皮 黄芩 桔梗	恶寒 无汗 头痛 身痛 恶寒发热 寒战 舌苔白 产后身痛 乳房红肿 目札
甘草 茯苓 当归 人参 白术 半夏 黄芩 防风 附子 白芍	头痛 咳嗽 鼻塞 身重 壮热 偏头痛 恶寒 身痛 小儿木舌 脏躁
甘草 茯苓 当归 人参 白术 附子 防风 羌活 川芎 干姜	腰痛 四肢麻木 骨痛 腰膝无力 关节疼痛 四肢疼痛 畏寒 半身不遂 背痛 足痛
甘草 当归 茯苓 人参 芍药 川芎 半夏 陈皮 黄芩 木香	盗汗 潮热 自汗 消瘦 寒热往来 面色白 腰痛 善食易饥 声音嘶哑 朱砂掌
甘草 当归 茯苓 人参 白术 陈皮 半夏 柴胡 黄芩 芍药	咳嗽 麻疹 气喘 干呕 胁痛 胸痛 目昏 头痛 脏躁 妊娠心腹胀满
甘草 茯苓 人参 当归 木香 白术 陈皮 半夏 厚朴 枳壳	腹痛 积滞 反胃 疳积 噎膈 腹满 消瘦 面色青 胃痛 小儿腹痛
甘草 当归 黄芩 茯苓 大黄 桔梗 人参 防风 黄连 石膏	烦躁 大便秘结 口臭 牙痛 舌干 口渴 麻疹 鼻干 咽肿 咽喉痛
甘草 人参 茯苓 当归 白术 川芎 黄芩 防风 柴胡 白芍	头痛 鼻塞 恶风 壮热 恶寒 无汗 呵欠 喷嚏 痄腮 舌麻
甘草 人参 茯苓 当归 白术 木香 白芍 陈皮 川芎 芍药	不孕 自汗 盗汗 小便频数 崩漏 遗尿 腹冷 目昏 面色青 脱肛
甘草 茯苓 当归 人参 白术 半夏 附子 芍药 川芎 陈皮	腹痛 肠鸣 里急后重 腹冷 转筋 大便脓血 大便艰难 睑弦赤烂 大便失禁 天疱疮
甘草 茯苓 白术 人参 当归 木香 白芍 陈皮 川芎 黄芩	白带 赤白带 崩漏 月经过多 闭经 过期不产 妇人腹痛 腹冷 脐湿 体臭
甘草 人参 茯苓 当归 黄芩 半夏 白术 桔梗 大黄 芍药	烦躁 神昏 谵语 发狂 口渴 头汗 口中生疮 舌卷 舌生芒刺 手舞足蹈
甘草 当归 黄芩 防风 茯苓 芍药 人参 川芎 桔梗 黄连	瘰疬 无名肿毒 臁疮 丹毒 痄腮 小儿丹毒 胎毒 阴疮 带状疱疹 耳痛
甘草 茯苓 人参 当归 白术 半夏 附子 芍药 黄芩 防风	浮肿 小便不利 短气 恶风 发黄 腹满 多唾 腰脊痛 少气 牙痛
甘草 人参 当归 茯苓 白术 芍药 黄芩 半夏 川芎 防风	口噤 角弓反张 痫 项强 四肢拘急 舌强 急惊 神昏 头摇 四肢强直
甘草 茯苓 人参 当归 白术 黄芩 白芍 半夏 川芎 柴胡	口渴 咽干 烦躁 咳嗽 舌苔黄 麻疹 舌苔黄腻 低热 舌裂 喉痒
甘草 当归 茯苓 人参 白术 白芍 陈皮 川芎 五味子 桑	头晕 健忘 心悸 食欲不振 疲乏 多梦 头昏 畏寒 须发早白 脱发
甘草 茯苓 人参 当归 木香 半夏 白术 陈皮 防风 枳壳	腹痛 胸闷 转筋 手足厥冷 头昏 舌苔白 上吐下泻 干呕 胸痛 头痛
甘草 当归 人参 茯苓 白术 川芎 防风 半夏 芍药 木香	半身不遂 瘫痪 耳聋 腰痛 骨痛 舌强 言语错乱 瘰疬 皮肤瘙痒 臂痛
甘草 茯苓 当归 人参 白术 半夏 黄芩 芍药 附子 防风	咳嗽 气喘 潮热 烦躁 小儿发热 胎动不安 背热 口淡 气从少腹上冲 鼻翼煽动
甘草 茯苓 当归 人参 白术 黄芩 川芎 半夏 柴胡 陈皮	头痛 咳嗽 壮热 鼻塞 恶寒 妊娠头痛 短气 口臭 血灌瞳神 目札
甘草 茯苓 白术 当归 人参 半夏 木香 厚朴 黄芩 陈皮	呕吐 腹痛 积滞 腹泻 大便秘结 食欲不振 消瘦 小儿呕吐 口臭 小便不利
甘草 人参 当归 茯苓 黄芩 白术 大黄 柴胡 陈皮 半夏	壮热 头痛 烦躁 四肢疼痛 小便黄赤 头重 鼻干 发黄 面色青 口渴
甘草 茯苓 当归 人参 白术 川芎 大黄 芍药 陈皮 黄芩	呕吐 恶心 吞酸 肠鸣 舌麻 漏下 自汗 产后胁痛 小便不通 腹满
