蒲公英 儿茶 芙蓉花 马齿苋 桉油 射干 葱白 淡豆豉 苦地丁 诃子	慢惊 口噤 急惊 骨痛 难产 胸痛 舌苔白 脱肛 阴疮 鼻塞
大麦 制何首乌 野马追 菠菜 桑寄生 蕤仁 龙胆 南沙参 白附子 鲜地黄	吐血 短气 烦躁 四肢麻木 无名肿毒 大便下血 鼻干 口淡 小便黄赤 腰痛
太子参 徐长卿 香加皮 硫黄 鹤草芽 竹茹 白薇 樟脑 苘麻子 天门冬	头痛 无汗 少气 寒热往来 食欲不振 瘫痪 咳血 噎膈 闭经 小便不通
苦杏仁 白术 紫檀 玉米须 饴糖 狗宝 花蕊石 香加皮 鹿角胶 大戟	耳聋 恶风 鼻衄 大便秘结 杨梅疮 项强 面色青 恶寒发热 皮肤瘙痒 咽肿
蜂蜜 白前 杠板归 锁阳 秦艽 益智 龟甲胶 藏青果 丁香 金钱白花蛇	烦躁 口苦 里急后重 口臭 赤白带 腹冷 胎毒 壮热 呕吐 产后腹痛
赭石 马蔺子 苍耳 苘麻 大血藤 熊胆 茶叶 制草乌 龙齿 柿蒂	痫 口渴 神昏 头痛 上吐下泻 阴痒 嗳气 恶风 便血 恶寒发热
冰片 一点红 八月札 山楂 蔓荆子 丹参 苦参 爵床 淡豆豉 人参芦	壮热 目昏 积滞 发黄 偏头痛 喉痒 寒战 盗汗 咽干 脐湿
郁李 穿山龙 荜茇 罂粟壳 龙眼 冬葵子 雷公藤 使君子 天南星 夜明砂	小便不利 气喘 潮热 呃逆 流泪 拳毛倒睫 大便秘结 食欲不振 小儿丹毒 舌卷
板栗 佩兰 鸡眼草 鲜地黄 千年健 栀子 黄药子 五加 人中白 银柴胡	白带 咳嗽 消瘦 胎动不安 畏寒 四肢疼痛 小儿口疮 疲乏 恶寒 但热不寒
绵马贯众 金沸草 糙苏 两头尖 槲寄生 独活 冬虫夏草 翻白草 鲜地黄 滑石	心烦 鼻塞 烦躁 浮肿 腹冷 多梦 大便溏 呕吐 腰脊痛 头晕
瓜蒌子 升药 马宝 藏青果 竹叶 六月雪 牵牛子 木芙蓉 黄药子 鹿茸	呕吐 胸闷 恶寒 胃痛 多唾 远视 弄舌 月经过多 心下悸 产后血崩
滑石粉 茴香 耳草 侧柏叶 莲子心 千里光 狗脊 金莲花 半边莲 枸杞子	恶心 盗汗 咽干 小便频数 项强 胞衣不下 瘰疬 骨痛 咳痰 胬肉攀睛
连钱草 紫石英 甘松 竹茹 余甘子 苎麻根 益母草 荷叶 草乌 茴香	腹痛 健忘 麻疹 心悸 呕吐 疳积 关节疼痛 崩中 积滞 足颤
木芙蓉叶 琥珀 矮地茶 天花粉 咖啡 厚朴花 韭子 淡豆豉 羊蹄 益智仁	自汗 腹满 臁疮 便血 反胃 肠鸣 头晕 恶露不下 面色青 四肢强直
密蒙花 荸荠 蓖麻 透骨草 石决明 韭菜 益母草 臭牡丹 皂荚 杜鹃	牙痛 崩漏 五心烦热 漏下 角弓反张 崩中 头痛 头重 不寐 舌肿
杏 蜗牛 山茱萸 地龙 五指毛桃 泽漆 川木香 鹤虱 青葙子 淫羊藿	头痛 浮肿 赤白带 四肢疼痛 噎膈 发黄 少腹痛 妊娠咳嗽 产后浮肿 但热不寒
广枣 地龙 莨菪 绿萼梅 煅石膏 水蛭 广藿香 海参 金锦香 决明子	咳嗽 盗汗 咽干 身痛 嗳气 舌强 无名肿毒 反胃 须发早白 头汗
天仙子 苏木 冬瓜皮 罗布麻叶 佩兰 雷丸 苏合香 蓼蓝 水红花子 枸骨叶	腰痛 头痛 头昏 手足厥冷 心下痞 腰重 胎动不安 痄腮 牙龈肿痛 言语错乱
珍珠母 猪牙皂 白豆蔻 半枝莲 木耳 莲子心 糯稻根 雄黄 紫河车 鸡子黄	瘰疬 壮热 转筋 神昏 吞酸 胎漏 遗尿 皮肤瘙痒 臂痛 舌苔黄
郁金 铁苋菜 桑寄生 炮姜 青蒿 蚕砂 全蝎 牵牛 寒水石 功劳木	腹痛 半身不遂 干呕 瘫痪 带状疱疹 脐疮 小儿重舌 小儿痞块 食欲不振 皮肤结节
紫苏叶 藁本 火炭母 马鞭草 白芥 广金钱草 胡颓子 鬼箭羽 天麻 乌药	咳嗽 心烦 谵语 痫 肠鸣 脱肛 不孕 头热 耳聋 寒热往来
李子 前胡 荆芥 知母 犀角 葡萄 马鞭草 买麻藤 狗脊 山慈菇	恶寒 潮热 舌干 头晕 发狂 小便不通 胎动不安 咽喉痛 喷嚏 心悸
车前子 漏芦 金礞石 溪黄草 白英 半边莲 虎骨 甜瓜子 连翘 冬瓜子	腹痛 小便不通 吞酸 丹毒 烦躁 四肢拘急 心烦 目昏 舌苔黄腻 口噤
六月雪 水飞蓟 南天竹 玄明粉 苦木 锦灯笼 木芙蓉叶 柠檬 石榴 桂枝	呕吐 胁痛 嘈杂 身重 背痛 疳积 难产 头晕 湿疮 腰膝无力
广藿香 密蒙花 白矾 松花粉 木蝴蝶 防风 一枝黄花 苘麻 大蒜 余甘子	咳嗽 腹泻 尿血 脱发 足热 小儿发热 脏躁 腰冷 噎膈 恶寒
