防风 独活 川乌 羌活 麻黄 乌头 草乌 牛膝 附子 细辛	口噤 半身不遂 瘫痪 骨痛 项强 角弓反张 四肢拘急 皮肤瘙痒 四肢麻木 杨梅疮
甘草 人参 茯苓 白术 炙甘草 陈皮 当归 白芍 桂枝 牛膝	恶寒 自汗 恶风 身重 恶寒发热 身痛 头重 寒战 呵欠 无汗
杜仲 牛膝 菟丝子 五味子 山茱萸 石斛 肉苁蓉 山药 枸杞子 续断	腰痛 头晕 耳聋 遗尿 不孕 小便频数 头昏 健忘 目昏 盗汗
杏 杏仁 桑 紫菀 麻黄 桑白皮 款冬花 五味子 桔梗 百合	咳嗽 气喘 咳痰 咳血 妊娠咳嗽 口渴 喉痒 痫 咽干 恶风
木香 丁香 豆蔻 沉香 肉豆蔻 茴香 附子 益智 白豆蔻 胡椒	呕吐 腹痛 肠鸣 恶心 腹冷 呃逆 反胃 噎膈 吞酸 里急后重
当归 桃 桃仁 红花 赤芍 川芎 芍药 肉桂 延胡索 牛膝	腹痛 难产 胁痛 腰痛 胞衣不下 恶露不下 胸痛 产后腹痛 闭经 少腹痛
桔梗 甘草 枳壳 半夏 前胡 茯苓 橘红 陈皮 旋覆花 瓜蒌	咳嗽 目昏 鼻塞 胸闷 气喘 胁痛 头痛 呃逆 舌苔白 多唾
连翘 薄荷 桔梗 荆芥 牛蒡 玄参 天花粉 竹叶 金银花 牛蒡子	口渴 麻疹 头痛 咳嗽 咽干 谵语 丹毒 烦躁 痄腮 牙痛
当归 白芍 川芎 香附 白术 芍药 熟地黄 阿胶 乌药 益母草	白带 赤白带 腹痛 胎动不安 崩漏 胎漏 难产 不孕 胁痛 漏下
麦冬 远志 茯苓 人参 山药 五味子 丹参 石菖蒲 酸枣仁 沙参	心悸 盗汗 健忘 自汗 头晕 心烦 口渴 不寐 多梦 胸闷
茯苓 木通 泽泻 滑石 车前 车前子 藜 猪苓 蒺藜 茵陈	小便不利 小便不通 目昏 发黄 流泪 小便黄赤 耳聋 远视 尿血 胬肉攀睛
朱砂 麝香 牛黄 僵蚕 天麻 白附子 天南星 全蝎 附子 雄黄	痫 慢惊 急惊 神昏 口噤 角弓反张 发狂 头痛 四肢抽搐 舌强
甘草 升麻 黄芩 犀角 大黄 栀子 麦门冬 石膏 羚羊角 玄参	烦躁 壮热 痫 谵语 发狂 咽喉痛 心烦 神昏 咽肿 四肢疼痛
生姜 人参 半夏 甘草 茯苓 白术 大枣 厚朴 枳实 竹茹	呕吐 短气 腹满 干呕 心下痞 少气 小儿呕吐 反胃 胁痛 多唾
防风 白芷 川芎 羌活 细辛 荆芥 薄荷 苍术 藁本 菊花	头痛 鼻塞 目昏 头昏 恶风 项强 身痛 牙痛 无汗 偏头痛
乳香 麝香 没药 雄黄 冰片 轻粉 朱砂 血竭 硼砂 白芷	瘰疬 臁疮 无名肿毒 牙痛 杨梅疮 湿疮 胎毒 粉刺 流泪 小儿口疮
干姜 附子 人参 白术 吴茱萸 细辛 肉桂 甘草 乌头 硫黄	腹痛 短气 少气 手足厥冷 背痛 面色青 耳聋 腹冷 转筋 小便频数
甘草 石膏 麻黄 黄芩 葛根 柴胡 芍药 升麻 赤芍 知母	头痛 壮热 无汗 恶寒 鼻干 项强 恶风 胸痛 腰脊痛 背痛
黄连 黄芩 黄柏 大黄 栀子 青黛 龙胆 胡黄连 芦荟 郁金	壮热 烦躁 里急后重 大便秘结 疳积 口臭 消瘦 丹毒 腹痛 舌肿
芍药 当归 赤芍 甘草 生地黄 牡丹 牡丹皮 麦门冬 白芍 黄芩	心烦 吐血 烦躁 鼻衄 四肢疼痛 五心烦热 潮热 寒热往来 少气 头重
陈皮 半夏 茯苓 甘草 厚朴 白术 苍术 藿香 木瓜 生姜	呕吐 恶心 腹痛 转筋 头痛 大便溏 身重 舌苔白 上吐下泻 胸闷
陈皮 青皮 神曲 香附 山楂 砂仁 木香 厚朴 莪术 麦芽	吞酸 呕吐 恶心 腹痛 嘈杂 积滞 嗳气 胃痛 食欲不振 疳积
柴胡 甘草 人参 知母 地骨皮 麦门冬 鳖甲 茯苓 秦艽 枳壳	潮热 口苦 盗汗 舌干 心烦 咽干 寒热往来 消瘦 五心烦热 但热不寒
当归 阿胶 龙骨 牡蛎 赤石脂 地榆 乌梅 艾叶 蒲黄 桑	吐血 便血 脱肛 崩漏 崩中 漏下 尿血 鼻衄 大便下血 腹痛
槟榔 木香 大黄 巴豆 牵牛 枳壳 桑 防己 郁李 大腹皮	浮肿 气喘 小便不利 积滞 腹满 腹痛 大便秘结 小便不通 神昏 腰痛
