甘草 当归 茯苓 人参 白术 附子 芍药 防风 川芎 羌活	腰痛 咳嗽 四肢疼痛 短气 耳聋 背痛 浮肿 腰重 胎动不安 臂痛
甘草 茯苓 人参 当归 白术 芍药 附子 半夏 陈皮 干姜	短气 小便不利 少气 腹满 干呕 浮肿 身重 自汗 胸痛 多唾
甘草 人参 茯苓 当归 半夏 白术 黄芩 川芎 附子 芍药	头痛 壮热 鼻塞 但热不寒 偏头痛 鼻痒 寒战 瞳神散大 牙齿浮动 红疹
甘草 当归 茯苓 人参 白术 川芎 防风 附子 半夏 芍药	半身不遂 瘫痪 目昏 四肢麻木 骨痛 腰痛 腰膝无力 皮肤瘙痒 头昏 关节疼痛
甘草 人参 茯苓 当归 白术 黄芩 半夏 川芎 陈皮 附子	痫 慢惊 急惊 神昏 不寐 弄舌 口中生疮 发癫 啮齿 善食易饥
甘草 人参 茯苓 当归 白术 黄芩 半夏 芍药 川芎 白芍	心烦 潮热 盗汗 寒热往来 五心烦热 咽干 头昏 消瘦 妊娠心烦 善怒
甘草 当归 茯苓 黄芩 防风 人参 川芎 大黄 黄连 桔梗	瘰疬 无名肿毒 臁疮 杨梅疮 丹毒 麻疹 胎毒 痄腮 湿疮 皮肤瘙痒
甘草 茯苓 当归 人参 白术 陈皮 半夏 黄芩 木香 防风	咳嗽 气喘 胸闷 鼻塞 咳痰 喉痒 麻疹 畏寒 妊娠咳嗽 背冷
甘草 茯苓 当归 人参 白术 黄芩 芍药 半夏 木香 川芎	目昏 口苦 舌干 耳聋 胁痛 咽干 小便频数 小便黄赤 远视 阴痒
甘草 当归 茯苓 黄芩 人参 防风 桔梗 黄连 川芎 白术	咳嗽 牙痛 大便秘结 口臭 头痛 鼻干 咽喉痛 舌肿 大便下血 咽肿
甘草 当归 茯苓 白术 人参 白芍 陈皮 芍药 木香 半夏	盗汗 自汗 潮热 咳嗽 消瘦 寒热往来 烦躁 小儿厌食 舌光 头汗
甘草 茯苓 当归 白术 人参 陈皮 半夏 木香 附子 川芎	腹痛 积滞 呕吐 疳积 反胃 噎膈 腹泻 口淡 大便溏 胸闷
甘草 当归 茯苓 人参 川芎 白术 芍药 木香 附子 香附	腹痛 漏下 难产 崩中 胎动不安 浮肿 胎漏 胞衣不下 恶露不下 产后腹痛
甘草 茯苓 人参 白术 当归 半夏 木香 川芎 附子 陈皮	腹痛 肠鸣 里急后重 转筋 手足厥冷 面色青 腹冷 上吐下泻 头胀 失语
甘草 茯苓 当归 人参 白术 芍药 陈皮 附子 木香 半夏	浮肿 小便不通 小便不利 腹满 气喘 发黄 心下痞 胁痛 咳嗽 大便溏
甘草 茯苓 人参 黄芩 当归 白术 白芍 柴胡 半夏 大黄	咳嗽 口渴 烦躁 咽干 心烦 舌苔黄 口苦 大便秘结 胁痛 舌苔黄腻
甘草 茯苓 人参 当归 陈皮 白术 半夏 黄芩 白芍 芍药	恶寒 头痛 无汗 身痛 恶寒发热 鼻塞 恶风 舌苔白 身重 舌苔白腻
甘草 当归 茯苓 人参 黄芩 白术 川芎 黄连 芍药 陈皮	吐血 咳嗽 便血 鼻衄 流泪 脱肛 遗尿 咳血 尿血 胬肉攀睛
甘草 茯苓 当归 人参 白术 黄芩 川芎 半夏 防风 黄连	烦躁 神昏 谵语 麻疹 发狂 口渴 壮热 四肢抽搐 带状疱疹 口流涎
甘草 茯苓 当归 人参 川芎 陈皮 黄芩 白术 枳壳 白芍	呕吐 吞酸 恶心 嘈杂 嗳气 呃逆 胃痛 食欲不振 目札 战汗
甘草 人参 茯苓 当归 白术 黄芩 芍药 川芎 半夏 防风	口噤 恶风 项强 痫 角弓反张 头痛 四肢拘急 舌强 头重 呵欠
甘草 当归 人参 茯苓 川芎 白术 黄芩 半夏 防风 柴胡	呕吐 恶心 腹痛 干呕 小儿呕吐 四肢抽搐 头晕 喉中痰鸣 积滞 鼻流涕
甘草 茯苓 当归 白术 人参 川芎 陈皮 芍药 木香 白芷	白带 赤白带 崩漏 不孕 腹冷 小便频数 脱肛 闭经 腰痛 乳房胀痛
甘草 茯苓 当归 人参 白术 附子 黄芩 半夏 木香 芍药	壮热 头痛 咳嗽 小便不通 妊娠头痛 针眼 难产 少气 鼻衄 漏下
甘草 当归 茯苓 人参 白术 白芍 川芎 陈皮 黄芩 五味子	头晕 健忘 心悸 食欲不振 多梦 疲乏 畏寒 胸闷 不寐 头昏
