当归 阿胶 白芍 川芎 香附 艾叶 熟地黄 白术 延胡索 甘草	吐血 胎动不安 崩漏 便血 胎漏 鼻衄 漏下 尿血 腹冷 骨痛
茯苓 白术 甘草 泽泻 陈皮 人参 猪苓 苍术 柴胡 枳壳	小便不利 浮肿 身重 大便溏 臂痛 目昏 头重 鼻塞 吞酸 咳痰
麻黄 甘草 桂枝 葛根 芍药 石膏 葱白 防风 黄芩 生姜	无汗 恶风 头痛 恶寒 大便溏 舌肿 畏寒 神昏 反胃 皮肤瘙痒
黄连 青黛 胡黄连 麝香 芦荟 使君子 龙胆 芜荑 熊胆 大黄	疳积 壮热 消瘦 口臭 潮热 鼻干 腹痛 鼻痒 心烦 头热
木香 沉香 丁香 巴豆 槟榔 巴豆霜 青木香 茴香 母丁香 青皮	腹痛 里急后重 壮热 胸闷 痫 耳聋 腹泻 声音嘶哑 大便溏 半身不遂
槟榔 牵牛 木香 枳壳 郁李 防己 郁李仁 大黄 大腹皮 牵牛子	浮肿 气喘 小便不利 烦躁 背痛 干呕 牙龈肿痛 寒热往来 胸痛 尿血
朱砂 牛黄 麝香 雄黄 冰片 琥珀 珍珠 钩藤 天竺黄 蟾酥	痫 神昏 牙痛 急惊 咳血 四肢疼痛 杨梅疮 关节疼痛 谵语 腰重
桑 杏 杏仁 桑白皮 麻黄 桑寄生 桑叶 地骨皮 橘红 人参	咳嗽 气喘 舌苔白 咽肿 嗳气 喉痒 腹泻 慢惊 寒战 腹满
人参 白术 甘草 茯苓 当归 干姜 麦门冬 白芍 远志 陈皮	自汗 盗汗 干呕 拳毛倒睫 头汗 头晕 麻疹 烦躁 五心烦热 恶心
神曲 砂仁 山楂 麦芽 陈皮 香附 青皮 厚朴 苍术 枳实	吞酸 嘈杂 嗳气 食欲不振 积滞 胃痛 呕吐 腹泻 胸闷 小儿厌食
豆蔻 丁香 肉豆蔻 沉香 木香 白豆蔻 草豆蔻 藿香 高良姜 胡椒	呕吐 肠鸣 恶心 吞酸 脱肛 反胃 面色青 呃逆 瘰疬 心下痞
甘草 人参 茯苓 白术 当归 白芍 陈皮 肉桂 柴胡 炙甘草	心烦 五心烦热 咽干 头晕 目干涩 唇肿 善怒 耳痛 面色青 喉痒
人参 甘草 白术 茯苓 芍药 当归 炙甘草 半夏 附子 苍术	自汗 短气 盗汗 目昏 恶风 背痛 腹痛 舌苔白 消瘦 口噤
防风 菊花 羌活 藜 蒺藜 羚羊角 荆芥 细辛 苦参 蔓荆子	目昏 流泪 皮肤瘙痒 远视 胬肉攀睛 近视 独语 胎毒 腹满 小儿发热
当归 甘草 柴胡 白芍 黄芩 川芎 芍药 陈皮 茯苓 白术	胁痛 耳聋 寒热往来 口苦 恶寒 少气 短气 鼻塞 大便秘结 胎毒
甘草 大黄 黄芩 栀子 芍药 柴胡 升麻 黄连 乌梅 赤芍	烦躁 谵语 壮热 发狂 口渴 气喘 呕吐 麻疹 头昏 大便溏
附子 干姜 肉桂 吴茱萸 硫黄 芥子 白芥 白芥子 人参 白术	腹冷 手足厥冷 转筋 畏寒 心烦 肠鸣 头重 痫 湿疮 反胃
乳香 没药 茴香 轻粉 冰片 血竭 小茴香 硼砂 蓖麻 儿茶	无名肿毒 臁疮 瘰疬 牙痛 湿疮 杨梅疮 胎毒 少腹痛 气喘 咳嗽
茯苓 白术 人参 甘草 陈皮 半夏 赭石 代赭石 生姜 旋覆花	呕吐 呃逆 小儿呕吐 大便秘结 头重 头晕 口淡 畏寒 不寐 项强
厚朴 藿香 陈皮 砂仁 苍术 木瓜 木香 香薷 草果 枳壳	腹痛 转筋 呕吐 恶心 腹泻 上吐下泻 胸闷 咳嗽 但热不寒 脱肛
生姜 半夏 陈皮 厚朴 人参 枳实 茯苓 白术 大枣 干姜	腹满 反胃 噎膈 心下痞 发狂 腹痛 月经过多 心烦 痫 腹泻
茯苓 半夏 白术 甘草 人参 陈皮 木香 苍术 生姜 黄连	呕吐 恶心 耳聋 噎膈 脱肛 腹痛 心下痞 腹满 咽干 少气
薄荷 荆芥 细辛 白芷 川芎 防风 荷叶 桔梗 甘草 苍术	鼻塞 头痛 牙痛 头昏 腰痛 牙龈肿痛 心下痞 四肢拘急 粉刺 小儿脐突
川乌 乌头 草乌 乳香 没药 威灵仙 牛膝 木瓜 五灵脂 地龙	半身不遂 瘫痪 骨痛 四肢麻木 关节疼痛 背冷 口苦 足颤 脱肛 头痛
白芷 细辛 防风 川芎 羌活 藁本 独活 麻黄 蔓荆子 苍术	头痛 鼻塞 恶风 呵欠 偏头痛 胃痛 目昏 腰痛 半身不遂 腹满
附子 白术 干姜 人参 甘草 木香 茯苓 当归 肉桂 炙甘草	腹痛 目昏 痫 面色青 气喘 消瘦 寒战 恶寒 干呕 头重
防风 独活 羌活 麻黄 五加 防己 五加皮 羚羊角 细辛 秦艽	口噤 项强 舌强 角弓反张 四肢拘急 恶心 头摇 神昏 壮热 小便黄赤
当归 桃 红花 桃仁 川芎 延胡索 蒲黄 赤芍 丹参 益母草	腹痛 难产 恶露不下 胞衣不下 带状疱疹 闭经 头晕 产后血崩 肠鸣 舌光
大黄 黄连 黄柏 巴豆 黄芩 皂荚 连翘 白矾 白及 白蔹	瘰疬 头痛 小儿口疮 耳聋 粉刺 头昏 乳房胀痛 痫 牙痛 嗳气
木通 滑石 车前 泽泻 车前子 瞿麦 猪苓 冬葵 大黄 冬葵子	小便不通 小便不利 尿血 小便黄赤 不寐 妊娠小便不通 便血 目昏 目干涩 尿痛
生地黄 黄连 黄柏 黄芩 麦门冬 天门冬 知母 栀子 甘草 竹茹	吐血 鼻衄 咳血 便血 谵语 骨痛 大便下血 崩中 小儿遗尿 面色白
麦冬 玄参 桑 沙参 天冬 知母 天花粉 女贞 女贞子 丹参	口渴 咽干 头晕 脱发 须发早白 潮热 不寐 浮肿 赤脉传睛 项强
半夏 陈皮 厚朴 生姜 茯苓 枳实 白术 甘草 枳壳 附子	呕吐 恶心 寒战 大便下血 鼻干 背痛 腹满 肥胖 腹痛 胞衣不下
麝香 朱砂 全蝎 雄黄 僵蚕 天麻 牛黄 蜈蚣 天竺黄 胆南星	慢惊 痫 急惊 四肢抽搐 呵欠 发黄 小儿呕吐 腰膝无力 便血 寒战
甘草 石膏 竹叶 黄芩 淡竹 知母 淡竹叶 升麻 寒水石 连翘	头痛 口渴 烦躁 不寐 鼻衄 四肢拘急 肠鸣 咽肿 鼻干 鼻痛
菟丝子 肉苁蓉 牛膝 山茱萸 五味子 鹿茸 石斛 山药 鹿角 枸杞子	耳聋 头晕 不孕 小便频数 盗汗 头昏 腰膝无力 腰重 消瘦 腰脊痛
甘草 半夏 桔梗 生姜 枇杷叶 枇杷 竹茹 人参 枳壳 茯苓	咳嗽 干呕 头昏 神昏 鼻衄 四肢疼痛 恶寒 喉痒 鼻干 头痛
桔梗 枳壳 前胡 甘草 半夏 旋覆花 茯苓 赤芍 桑 知母	咳嗽 头痛 舌苔白 多唾 瘰疬 难产 角弓反张 鼻塞 口臭 恶风
犀角 升麻 麦门冬 栀子 玄参 羚羊角 石膏 射干 黄芩 寒水石	烦躁 壮热 舌肿 咽喉痛 咽干 血精 乳汁不行 头胀 经行腹痛 食欲不振
甘草 茯苓 人参 当归 白术 半夏 苍术 白芍 麦门冬 柴胡	烦躁 头痛 身重 阴疮 口淡 吐血 弄舌 身痛 湿疮 背痛
人参 麦门冬 甘草 大枣 生姜 五味子 茯苓 白术 小麦 附子	短气 少气 自汗 背痛 面色青 谵语 盗汗 但热不寒 头痛 舌疮
连翘 荆芥 牛蒡 薄荷 牛蒡子 金银花 桔梗 蝉蜕 天花粉 防风	麻疹 丹毒 杨梅疮 鼻塞 痄腮 口渴 咽肿 小儿丹毒 牙痛 咽干
附子 白附子 天麻 天南星 僵蚕 益智 益智仁 全蝎 麝香 生姜	慢惊 神昏 口噤 急惊 角弓反张 肠鸣 四肢强直 小便黄赤 半身不遂 但热不寒
防风 羌活 川芎 白芷 苍术 独活 荆芥 细辛 桔梗 甘草	恶寒 恶寒发热 身痛 无汗 头重 咳嗽 目昏 耳聋 四肢拘急 口苦
甘草 人参 柴胡 黄芩 炙甘草 麦门冬 当归 白芍 茯苓 郁金	舌干 口苦 咽干 壮热 盗汗 胸痛 口臭 咳嗽 舌卷 腹痛
干姜 吴茱萸 人参 附子 甘草 茯苓 白术 厚朴 细辛 生姜	腹痛 背痛 腹满 面色青 恶风 鼻干 胁痛 咽喉痛 杨梅疮 自汗
甘草 枳壳 桔梗 茯苓 前胡 半夏 柴胡 橘红 乌梅 秦艽	咳嗽 寒热往来 头痛 脱肛 恶寒 盗汗 身痛 粉刺 胸痛 小便不利
大黄 黄芩 栀子 黄连 茵陈 枳实 黄柏 郁金 龙胆 柴胡	发黄 大便秘结 谵语 发狂 舌苔黄 小便黄赤 舌苔黄腻 腰痛 黄汗 小便不利
杏 杏仁 紫菀 款冬花 百合 五味子 百部 桑 白前 马兜铃	咳嗽 上吐下泻 湿疮 发狂 项强 妊娠咳嗽 四肢麻木 难产 半身不遂 腹中痞块
龙骨 牡蛎 赤石脂 当归 地榆 阿胶 蒲黄 艾叶 白芍 禹余粮	崩中 漏下 崩漏 脱肛 便血 遗尿 大便下血 小儿遗尿 烦躁 壮热
远志 石菖蒲 党参 五味子 酸枣仁 黄芪 丹参 柏子仁 熟地黄 山药	心悸 健忘 头晕 多梦 胸闷 疲乏 食欲不振 须发早白 少气 心烦
木香 青皮 槟榔 三棱 莪术 巴豆 香附 枳壳 干漆 牵牛	呕吐 积滞 恶心 吞酸 腹痛 胃痛 嘈杂 小便不通 手足厥冷 小儿腹痛
当归 白芍 川芎 香附 乌药 熟地黄 益母草 茯苓 砂仁 沉香	白带 赤白带 气喘 小儿木舌 崩中 产后发热 咽喉痛 经行腹痛 天疱疮 关节疼痛
芍药 赤芍 甘草 黄芩 柴胡 麻黄 石膏 大黄 人参 枳壳	壮热 头痛 目昏 胸痛 漏下 阴痛 舌干 腰重 头重 咽喉痛
柴胡 地骨皮 鳖甲 知母 秦艽 甘草 青蒿 麦门冬 常山 银柴胡	潮热 盗汗 寒热往来 四肢疼痛 身痛 口渴 阴疮 鼻衄 小儿鹅口 舌肿
石膏 黄芩 葛根 升麻 甘草 麻黄 柴胡 大黄 知母 栀子	壮热 头痛 小儿口疮 牙痛 呵欠 胎毒 潮热 言语错乱 足颤 反胃
芍药 赤芍 牡丹 牡丹皮 当归 大黄 延胡索 犀角 郁金 神曲	心烦 吐血 四肢疼痛 腹痛 鼻衄 便血 尿血 心下悸 消瘦 头晕
杜仲 牛膝 山药 肉桂 当归 续断 茯苓 芡实 薏苡仁 莲子	腰痛 白带 产后腰痛 小便频数 头重 胸闷 滑胎 鼻衄 腰膝无力 经行腹痛
桔梗 杏 杏仁 橘红 乌梅 半夏 瓜蒌 川贝母 五味子 枳壳	咳嗽 气喘 胸闷 咳痰 咽干 四肢疼痛 面痛 小便频数 小儿发热 小便清长
当归 桃 白芍 桃仁 川芎 甘草 芍药 红花 木香 干姜	腹痛 心烦 面色青 少腹痛 产后腹痛 粉刺 畏寒 胸痛 牙痛 偏头痛
