薄荷 连翘 荆芥 桔梗 竹叶 荷叶 淡竹 淡竹叶 金银花 樟脑	头痛 麻疹 头昏 瘰疬 咳嗽 丹毒 口渴 神昏 鼻干 恶风
天麻 僵蚕 白附子 全蝎 天南星 附子 蜈蚣 蝉蜕 麝香 朱砂	慢惊 痫 半身不遂 头痛 咳嗽 瘰疬 角弓反张 皮肤瘙痒 耳聋 急惊
桃 桃仁 红花 当归 川芎 延胡索 牛膝 泽兰 丹参 益母草	腹痛 难产 烦躁 胸痛 恶露不下 崩中 漏下 大便秘结 消瘦 谵语
甘草 人参 茯苓 白术 当归 柴胡 白芍 陈皮 滑石 苍术	背痛 消瘦 腹痛 臂痛 咳嗽 小便不利 呕吐 寒热往来 心悸 壮热
厚朴 藿香 苍术 陈皮 香薷 木瓜 草果 砂仁 广藿香 白扁豆	呕吐 恶心 转筋 头痛 身重 恶寒 上吐下泻 腹泻 腹痛 食欲不振
杏 杏仁 苦杏仁 麻黄 紫苏子 葶苈子 百部 桔梗 川贝母 犀角	咳嗽 耳聋 气喘 恶寒 痫 无汗 小便不利 浮肿 胸闷 谵语
桔梗 牛蒡 龙骨 牛蒡子 白芷 赤石脂 荆芥 牡蛎 甘草 白矾	咳嗽 白带 瘰疬 盗汗 麻疹 头晕 丹毒 脱肛 痫 吐血
甘草 当归 乌梅 半夏 炙甘草 陈皮 罂粟 茯苓 罂粟壳 人参	腹痛 里急后重 咳嗽 消瘦 气喘 舌干 呕吐 烦躁 舌苔白 脱肛
桑 紫菀 桑白皮 款冬花 五味子 百部 百合 桑叶 天门冬 白前	咳嗽 短气 浮肿 气喘 咽干 咳血 头晕 盗汗 口渴 小便不利
甘草 人参 当归 茯苓 白术 半夏 柴胡 川芎 桔梗 麝香	腹痛 恶风 咽干 咳嗽 气喘 短气 舌强 呕吐 腹满 恶寒
远志 五味子 石菖蒲 酸枣仁 柏子仁 熟地黄 山药 山茱萸 丹参 麦门冬	健忘 耳聋 盗汗 短气 痫 自汗 多梦 心悸 头晕 咳嗽
大黄 巴豆 牵牛 槟榔 木香 牵牛子 皂荚 猪牙皂 巴豆霜 枳实	腹满 积滞 腹痛 大便秘结 瘰疬 里急后重 口噤 痫 小便不通 咽肿
朱砂 牛黄 麝香 雄黄 琥珀 天竺黄 冰片 钩藤 珍珠 赭石	痫 急惊 神昏 发狂 瘰疬 目昏 腹痛 心烦 四肢抽搐 谵语
麦门冬 甘草 人参 生地黄 天门冬 地骨皮 知母 五味子 茯苓 羚羊角	心烦 咳嗽 潮热 五心烦热 短气 吐血 盗汗 口渴 气喘 便血
白芷 川芎 细辛 防风 羌活 藁本 蔓荆子 荆芥 苍术 独活	头痛 鼻塞 白带 牙痛 骨痛 身痛 无汗 偏头痛 浮肿 恶风
甘草 柴胡 黄芩 枳壳 大黄 黄柏 白芍 栀子 陈皮 升麻	壮热 头痛 咳嗽 头重 寒热往来 烦躁 腹痛 目昏 鼻衄 恶寒
半夏 甘草 茯苓 陈皮 人参 芥子 白芥 白芥子 枳实 枳壳	呕吐 腹满 咳嗽 口淡 恶心 大便秘结 反胃 壮热 肠鸣 嘈杂
川乌 乌头 草乌 白芷 川芎 乳香 苍术 五灵脂 没药 地龙	瘫痪 半身不遂 骨痛 口噤 身重 腰痛 白带 瘰疬 关节疼痛 鼻塞
升麻 犀角 玄参 羚羊角 连翘 黄芩 射干 龙齿 钩藤 蛇蜕	瘰疬 痫 咽喉痛 壮热 头痛 舌肿 脱肛 麻疹 弄舌 口臭
生姜 厚朴 半夏 大枣 葱白 枳实 白矾 小麦 黄连 陈皮	呕吐 恶寒 头痛 咳嗽 鼻塞 恶寒发热 脏躁 舌苔黄 小儿呕吐 腹痛
肉桂 附子 白术 干姜 当归 人参 川芎 山药 木香 半夏	浮肿 腹痛 短气 畏寒 腰痛 头晕 气喘 呕吐 腹冷 恶心
甘草 人参 白术 茯苓 当归 炙甘草 半夏 犀角 升麻 芍药	腹痛 壮热 口苦 咳嗽 恶风 鼻干 气喘 舌干 自汗 咽干
当归 白芍 川芎 芍药 炙甘草 生姜 白薇 白芷 红花 木香	腹痛 头痛 自汗 盗汗 胁痛 崩漏 恶风 恶心 大便下血 赤白带
防风 羌活 菊花 独活 细辛 羚羊角 荆芥 木贼 石决明 决明子	目昏 头痛 流泪 无汗 身痛 鼻塞 浮肿 拳毛倒睫 发狂 痫
防风 荆芥 羌活 藜 蒺藜 白芷 苦参 独活 薄荷 苍耳	头痛 鼻塞 皮肤瘙痒 麻疹 身痛 白带 目昏 无汗 项强 赤白带
甘草 黄芩 大黄 黄连 桔梗 茯苓 枳壳 当归 升麻 槟榔	烦躁 咳嗽 腹痛 气喘 壮热 头痛 大便秘结 呕吐 舌干 手足厥冷
乳香 没药 轻粉 冰片 麝香 雄黄 血竭 朱砂 硼砂 穿山甲	无名肿毒 臁疮 瘰疬 杨梅疮 神昏 痫 心烦 胬肉攀睛 腹痛 赤白带
木香 沉香 丁香 槟榔 青皮 青木香 附子 檀香 母丁香 茴香	腹痛 呕吐 呃逆 里急后重 噎膈 小儿呕吐 腹冷 胃痛 头重 带状疱疹
甘草 茯苓 半夏 人参 白术 陈皮 桔梗 橘红 木通 炙甘草	恶风 呕吐 项强 咳嗽 气喘 腹痛 反胃 短气 小便不利 头痛
甘草 人参 茯苓 白术 附子 陈皮 枳壳 麦门冬 防风 木香	壮热 少气 咳嗽 舌干 气喘 腹痛 慢惊 肠鸣 自汗 舌强
黄芩 大黄 甘草 连翘 郁金 金银花 黄连 天花粉 栀子 玄参	谵语 烦躁 头痛 咳嗽 神昏 吐血 丹毒 口渴 舌苔黄 麻疹
芍药 当归 牡丹 牡丹皮 赤芍 生地黄 白芍 川芎 升麻 白矾	鼻衄 吐血 崩中 腹痛 腰重 五心烦热 潮热 咽干 咳血 短气
阿胶 当归 艾叶 地榆 蒲黄 鹿角 白芍 鹿角胶 续断 川芎	吐血 白带 便血 赤白带 崩漏 腹痛 胎漏 尿血 胎动不安 咳嗽
桑 山药 党参 黄芪 丹参 桑寄生 何首乌 芡实 莲子 女贞	头晕 白带 心悸 头昏 目昏 烦躁 浮肿 健忘 须发早白 自汗
神曲 陈皮 山楂 麦芽 厚朴 香附 砂仁 枳实 苍术 青皮	恶心 嘈杂 食欲不振 吞酸 积滞 腹痛 腹满 腹泻 嗳气 口臭
麻黄 防风 桂枝 甘草 细辛 羌活 附子 独活 防己 五味子	恶寒 头痛 无汗 浮肿 气喘 恶寒发热 咳嗽 胸闷 鼻塞 小便不利
石膏 葛根 知母 升麻 麻黄 寒水石 黄芩 麦门冬 芍药 甘草	头痛 壮热 口渴 咽干 心烦 谵语 牙痛 自汗 神昏 发狂
柴胡 鳖甲 知母 地骨皮 秦艽 甘草 黄芩 青蒿 人参 黄连	潮热 寒热往来 盗汗 五心烦热 头痛 胁痛 咳嗽 但热不寒 烦躁 气喘
茯苓 泽泻 白术 猪苓 甘草 木通 陈皮 山药 柴胡 苍术	小便不利 呕吐 小便黄赤 心下痞 大便下血 发黄 自汗 白带 腹痛 小便频数
黄连 黄柏 黄芩 大黄 栀子 甘草 柴胡 当归 生地黄 知母	烦躁 心烦 不寐 吞酸 呕吐 盗汗 牙痛 神昏 胸闷 唇肿
白术 人参 茯苓 当归 甘草 芍药 生地黄 五味子 酸枣仁 麦门冬	少气 腹痛 自汗 小便不利 慢惊 烦躁 呕吐 短气 咳嗽 大便溏
干姜 附子 吴茱萸 硫黄 半夏 白术 当归 龙骨 厚朴 细辛	呕吐 手足厥冷 面色青 腹冷 腹痛 吞酸 干呕 赤白带 头痛 小儿腹痛
附子 干姜 细辛 防风 人参 当归 白术 甘草 麻黄 丹参	口噤 角弓反张 项强 鼻塞 呕吐 头痛 腹冷 牙痛 自汗 恶寒
甘草 半夏 茯苓 陈皮 人参 厚朴 白术 枳壳 枳实 黄芩	呕吐 恶心 咳嗽 鼻衄 恶寒 反胃 头痛 气喘 耳聋 寒战
三棱 茴香 莪术 木香 青皮 槟榔 小茴香 巴豆 川楝子 干漆	腹痛 赤白带 腰痛 恶心 消瘦 里急后重 腹冷 胸闷 心下痞 烦躁
白芍 当归 川芎 熟地黄 香附 益母草 白术 延胡索 细辛 肉桂	腹痛 头痛 盗汗 赤白带 自汗 崩漏 难产 目昏 漏下 吞酸
甘草 人参 茯苓 麦门冬 竹茹 半夏 芦根 当归 柴胡 白术	干呕 呕吐 吐血 心烦 壮热 舌强 咳嗽 腹痛 短气 反胃
芍药 赤芍 当归 甘草 柴胡 川芎 羚羊角 防己 枳壳 磁石	壮热 四肢疼痛 腹痛 吐血 胁痛 耳聋 头晕 转筋 粉刺 阴疮
槟榔 枳壳 木香 防己 郁李仁 郁李 木通 大腹皮 桑 甘遂	浮肿 里急后重 腹痛 小便不利 小便不通 积滞 耳聋 脱肛 瘰疬 腹满
麦冬 玄参 桔梗 沙参 橘红 天冬 知母 瓜蒌 天花粉 川贝母	口渴 咳嗽 咽干 心烦 喉痒 瘰疬 潮热 壮热 舌疮 大便秘结
防风 牛膝 独活 秦艽 木瓜 五加 五加皮 羌活 薏苡仁 防己	转筋 杨梅疮 四肢麻木 四肢拘急 腰痛 半身不遂 浮肿 面色青 足痛 腹痛
麝香 黄连 青黛 朱砂 胡黄连 雄黄 芦荟 使君子 芜荑 牛黄	疳积 烦躁 痫 潮热 瘰疬 心烦 腹痛 盗汗 急惊 神昏
滑石 木通 车前 车前子 牡蛎 龙骨 瞿麦 石榴 赤石脂 冬葵	小便不通 盗汗 小便不利 自汗 瘰疬 头晕 吞酸 赤白带 尿血 湿疮
白术 人参 茯苓 甘草 半夏 当归 柴胡 黄连 枳壳 枳实	腹满 腹痛 呕吐 口苦 小便不利 短气 自汗 壮热 噎膈 气喘
杜仲 牛膝 菟丝子 肉苁蓉 石斛 枇杷 枇杷叶 续断 鹿茸 山茱萸	腰痛 目昏 耳聋 不孕 头晕 小便频数 腰膝无力 胎动不安 远视 胞衣不下
豆蔻 丁香 肉豆蔻 木香 益智 沉香 胡椒 白豆蔻 草豆蔻 藿香	呕吐 肠鸣 口臭 腹痛 小便频数 呃逆 遗尿 吞酸 胸闷 腹冷
桔梗 前胡 枳壳 旋覆花 甘草 半夏 紫苏叶 大腹皮 茯苓 橘红	咳嗽 壮热 胁痛 胸闷 多唾 脱肛 浮肿 咽干 心下痞 粉刺
黄芩 栀子 大黄 茵陈 黄连 龙胆 黄柏 柴胡 升麻 茵陈蒿	发黄 头痛 口苦 心烦 烦躁 耳聋 咳嗽 胁痛 壮热 胸闷
香附 砂仁 陈皮 木香 乌药 青皮 川芎 姜黄 枳壳 黄连	恶心 腹痛 吞酸 呕吐 嗳气 胎动不安 咳嗽 急惊 经行腹痛 胁痛
甘草 茯苓 人参 半夏 当归 麦门冬 白术 黄芩 知母 附子	舌干 口苦 咳嗽 腹痛 呕吐 小便不利 气喘 潮热 四肢拘急 心烦
