防风 羌活 川芎 荆芥 独活 白芷 细辛 薄荷 天麻 苍术	头痛 项强 无汗 身痛 鼻塞 麻疹 浮肿 目昏 骨痛 慢惊
甘草 茯苓 人参 白术 枳壳 陈皮 干姜 前胡 厚朴 当归	恶风 腹痛 咳嗽 气喘 小便不利 阴疮 头重 呕吐 自汗 口噤
木通 滑石 泽泻 车前 车前子 猪苓 瞿麦 冬葵 冬葵子 石韦	小便不通 小便不利 难产 小便黄赤 尿血 舌疮 带状疱疹 烦躁 大便下血 恶风
杏 杏仁 麻黄 苦杏仁 紫苏子 紫苏叶 葶苈子 川贝母 瓜蒌 百部	咳嗽 气喘 耳聋 恶寒 胸闷 无汗 痫 浮肿 喉痒 头痛
升麻 犀角 羚羊角 麦门冬 玄参 大黄 钩藤 龙齿 木通 射干	壮热 痫 心烦 咽喉痛 脱肛 麻疹 头痛 瘰疬 发狂 神昏
干姜 附子 吴茱萸 硫黄 细辛 肉桂 厚朴 当归 阳起石 生姜	呕吐 手足厥冷 腹痛 吞酸 腹冷 面色青 短气 肠鸣 畏寒 恶心
当归 白芍 川芎 香附 山药 鹿角 熟地黄 益母草 鹿角胶 芡实	白带 赤白带 腹痛 难产 吐血 崩漏 浮肿 漏下 自汗 盗汗
芍药 当归 牡丹 牡丹皮 生地黄 白芍 山药 熟地黄 泽泻 茯苓	吐血 白带 五心烦热 盗汗 目昏 赤白带 潮热 耳聋 漏下 腹痛
黄连 青黛 竹叶 胡黄连 淡竹 芦荟 麝香 使君子 淡竹叶 龙胆	烦躁 疳积 潮热 心烦 口臭 盗汗 神昏 呕吐 丹毒 咳嗽
柴胡 鳖甲 地骨皮 知母 枳壳 秦艽 黄芩 青蒿 桔梗 乌梅	潮热 寒热往来 盗汗 胁痛 头痛 五心烦热 烦躁 吐血 咳嗽 脱肛
甘草 麦门冬 人参 竹茹 枇杷 枇杷叶 芦根 桔梗 茯苓 橘红	干呕 心烦 咳嗽 吐血 呕吐 腹痛 气喘 口渴 舌强 咽干
桃 桃仁 红花 大黄 当归 甘遂 赤芍 芫花 大戟 蒲黄	腹满 腹痛 胸痛 恶露不下 小便不通 少腹痛 鼻衄 崩中 消瘦 粉刺
茯苓 甘草 人参 白术 半夏 干姜 乌梅 当归 炙甘草 陈皮	呕吐 腹痛 舌干 小便不利 腹满 自汗 咳嗽 口苦 气喘 咽干
神曲 陈皮 山楂 麦芽 香附 砂仁 枳实 厚朴 青皮 苍术	恶心 嘈杂 食欲不振 吞酸 腹痛 积滞 嗳气 大便秘结 腹泻 腹满
半夏 茯苓 枳实 甘草 橘红 陈皮 芥子 白芥 白芥子 枳壳	呕吐 腹满 心下痞 反胃 大便秘结 咳嗽 恶寒 头痛 臂痛 壮热
当归 甘草 牡蛎 龙骨 白芍 芍药 人参 柴胡 麻黄 小麦	盗汗 瘰疬 腹痛 自汗 咳嗽 气喘 胃痛 短气 心悸 恶寒
桑 当归 党参 白芍 丹参 黄芪 桑寄生 何首乌 三七 女贞	头晕 头昏 心悸 腹痛 吐血 烦躁 自汗 须发早白 腰痛 心烦
木香 香附 砂仁 陈皮 乌药 沉香 青皮 枳壳 姜黄 郁金	恶心 腹痛 呕吐 吞酸 嗳气 嘈杂 胎动不安 咳嗽 产后腹痛 呃逆
黄芩 栀子 大黄 黄连 茵陈 龙胆 柴胡 甘草 升麻 茵陈蒿	发黄 烦躁 头痛 心烦 舌苔黄 口苦 腹痛 壮热 舌苔黄腻 咳嗽
阿胶 艾叶 龙骨 地榆 赤石脂 蒲黄 当归 牡蛎 乌梅 赭石	吐血 便血 白带 崩漏 赤白带 崩中 腹痛 漏下 胎漏 尿血
陈皮 厚朴 藿香 苍术 半夏 木瓜 草果 香薷 大腹皮 广藿香	呕吐 恶心 转筋 身重 头痛 恶寒 浮肿 咳嗽 上吐下泻 腹泻
槟榔 木香 大黄 枳壳 牵牛 郁李 郁李仁 牵牛子 防己 大腹皮	浮肿 腹痛 里急后重 积滞 大便秘结 小便不利 心下痞 烦躁 赤白带 呵欠
丁香 豆蔻 木香 肉豆蔻 沉香 白豆蔻 胡椒 草豆蔻 诃子 高良姜	呕吐 肠鸣 腹痛 呃逆 口臭 腹冷 恶心 吞酸 胸闷 小儿呕吐
茴香 菊花 防风 藜 蒺藜 荆芥 苦参 羌活 小茴香 川楝子	目昏 流泪 头痛 腰痛 皮肤瘙痒 头昏 远视 鼻塞 拳毛倒睫 腹冷
天麻 僵蚕 附子 白附子 全蝎 天南星 麝香 朱砂 蜈蚣 牛黄	慢惊 痫 半身不遂 头痛 咳嗽 瘰疬 角弓反张 急惊 神昏 目昏
桑 紫菀 桑白皮 款冬花 五味子 百合 桔梗 百部 桑叶 天门冬	咳嗽 浮肿 短气 咳血 咽干 头晕 气喘 妊娠咳嗽 头痛 小便不利
白芷 川芎 细辛 防风 羌活 藁本 荆芥 苍术 蔓荆子 白薇	头痛 鼻塞 牙痛 白带 骨痛 浮肿 身痛 无汗 偏头痛 身重
防风 独活 羌活 牛膝 秦艽 五加 五加皮 防己 麻黄 木瓜	口噤 四肢麻木 转筋 四肢拘急 项强 角弓反张 头痛 恶寒 舌强 瘫痪
乳香 没药 轻粉 麝香 雄黄 血竭 朱砂 白及 冰片 蓖麻	无名肿毒 臁疮 瘰疬 杨梅疮 难产 吐血 白带 腹痛 痫 神昏
麦冬 玄参 知母 甘草 桔梗 沙参 天冬 天花粉 黄芩 丹参	口渴 咳嗽 咽干 心烦 瘰疬 烦躁 潮热 气喘 咳痰 胸闷
川乌 附子 乌头 白矾 草乌 细辛 干姜 皂荚 五灵脂 硫黄	口噤 瘫痪 半身不遂 痫 角弓反张 鼻塞 骨痛 鼻衄 腰痛 瘰疬
人参 白术 茯苓 甘草 干姜 当归 炙甘草 陈皮 白芍 黄芩	消瘦 烦躁 壮热 腹痛 自汗 呕吐 口苦 咳嗽 小便不利 舌干
肉桂 当归 薄荷 附子 荷叶 川芎 甘草 白术 干姜 炮姜	腹痛 浮肿 短气 腰痛 畏寒 气喘 头晕 头痛 口苦 腹冷
甘草 人参 茯苓 白术 附子 当归 炙甘草 乌梅 半夏 芍药	恶风 腹痛 头重 咳嗽 自汗 腰脊痛 小便不利 呕吐 寒战 慢惊
黄连 黄柏 黄芩 大黄 栀子 知母 生地黄 升麻 麦门冬 犀角	烦躁 心烦 盗汗 牙痛 咳嗽 神昏 谵语 呕吐 潮热 不寐
当归 白芍 川芎 甘草 芍药 生地黄 丹参 地骨皮 香附 茯苓	腹痛 自汗 头痛 大便下血 盗汗 崩漏 五心烦热 胁痛 心悸 目昏
茯苓 甘草 陈皮 半夏 白术 人参 炙甘草 黄芩 当归 柴胡	呕吐 咳嗽 腹痛 反胃 噎膈 面色青 舌苔白 气喘 小便不利 多唾
生姜 半夏 厚朴 大枣 葱白 桂枝 人参 附子 紫苏叶 干姜	呕吐 恶寒 头痛 咳嗽 鼻塞 恶寒发热 反胃 心悸 恶风 不射精
甘草 麻黄 细辛 防风 桂枝 桔梗 干姜 黄芩 枳壳 苍术	恶寒 咳嗽 头痛 无汗 气喘 浮肿 鼻塞 恶寒发热 腹痛 身痛
牛膝 杜仲 菟丝子 肉苁蓉 续断 石斛 山茱萸 五味子 鹿茸 枸杞子	腰痛 耳聋 目昏 头晕 不孕 腰膝无力 小便频数 胎动不安 短气 白带
甘草 白术 茯苓 人参 附子 当归 干姜 柴胡 黄连 绿豆	少气 背痛 腹痛 壮热 小便不利 短气 自汗 咳嗽 呕吐 目昏
桔梗 枳壳 前胡 半夏 旋覆花 甘草 瓜蒌 薄荷 茯苓 紫苏叶	咳嗽 壮热 胸闷 呕吐 呵欠 喷嚏 脱肛 咽干 胁痛 头痛
朱砂 麝香 牛黄 雄黄 冰片 琥珀 天竺黄 珍珠 硼砂 钩藤	痫 急惊 神昏 发狂 瘰疬 腹痛 慢惊 心烦 目昏 难产
石膏 葛根 麻黄 升麻 知母 黄芩 寒水石 柴胡 甘草 滑石	头痛 壮热 口渴 咽干 心烦 谵语 自汗 恶寒 发狂 牙痛
连翘 荆芥 薄荷 牛蒡 桔梗 牛蒡子 益智 金银花 益智仁 蝉蜕	瘰疬 麻疹 丹毒 杨梅疮 咳嗽 谵语 头痛 小便频数 遗尿 痄腮
甘草 黄芩 柴胡 大黄 郁金 枳壳 芍药 人参 知母 生地黄	舌干 口苦 咳嗽 头痛 气喘 寒热往来 腹痛 神昏 谵语 壮热
木香 巴豆 三棱 莪术 槟榔 青皮 丁香 沉香 巴豆霜 牵牛	腹痛 腹满 消瘦 积滞 瘰疬 里急后重 壮热 干呕 呃逆 呕吐
芍药 赤芍 当归 甘草 黄芩 川芎 升麻 连翘 附子 桔梗	鼻衄 四肢疼痛 壮热 腹痛 吐血 胁痛 谵语 黄汗 崩中 舌干
远志 五味子 麦门冬 人参 石菖蒲 柏子仁 酸枣仁 生地黄 天门冬 茯苓	健忘 耳聋 短气 盗汗 自汗 心烦 痫 多梦 心悸 咳嗽
甘草 茯苓 人参 白术 干姜 炙甘草 泽泻 枳壳 大枣 当归	少气 咳嗽 气喘 腹痛 烦躁 鼻干 面色青 小便不利 呕吐 壮热
