麦冬 甘草 桔梗 橘红 知母 瓜蒌 沙参 竹茹 玄参 川贝母	咳嗽 头痛 腹痛 呕吐 烦躁 心烦 咽干 口渴 气喘 痫
当归 川芎 白芍 香附 白术 茯苓 甘草 附子 人参 木香	白带 赤白带 崩漏 不孕 漏下 咳嗽 腹痛 头痛 呕吐 心烦
人参 麦门冬 五味子 茯苓 远志 天门冬 酸枣仁 生地黄 石菖蒲 柏子仁	咳嗽 腹痛 头痛 呕吐 心烦 烦躁 壮热 吐血 目昏 短气
木香 槟榔 枳壳 大黄 桑 茯苓 防己 木通 大腹皮 牵牛	咳嗽 腹痛 头痛 浮肿 呕吐 壮热 烦躁 心烦 目昏 气喘
麝香 朱砂 乳香 雄黄 冰片 没药 轻粉 牛黄 白矾 血竭	腹痛 咳嗽 头痛 呕吐 瘰疬 无名肿毒 烦躁 恶心 痫 壮热
当归 芍药 白芍 川芎 牡丹 甘草 生地黄 牡丹皮 赤芍 熟地黄	咳嗽 腹痛 头痛 盗汗 呕吐 心烦 烦躁 恶寒 壮热 吐血
薄荷 连翘 荆芥 桔梗 牛蒡 牛蒡子 竹叶 金银花 荷叶 淡竹	咳嗽 头痛 腹痛 烦躁 呕吐 壮热 恶寒 口渴 咽干 心烦
防风 菊花 甘草 藜 羌活 川芎 白芷 当归 荆芥 蒺藜	目昏 头痛 咳嗽 流泪 腹痛 皮肤瘙痒 呕吐 杨梅疮 壮热 痫
当归 阿胶 白芍 龙骨 牡蛎 赤石脂 地榆 蒲黄 艾叶 桑	腹痛 咳嗽 头痛 心烦 呕吐 壮热 吐血 烦躁 痫 瘰疬
防风 羌活 白芷 川芎 独活 细辛 荆芥 麻黄 苍术 藁本	头痛 咳嗽 恶寒 腹痛 鼻塞 壮热 呕吐 瘰疬 痫 自汗
白术 甘草 茯苓 白芍 山药 陈皮 当归 人参 炙甘草 党参	咳嗽 腹痛 呕吐 头痛 自汗 心烦 烦躁 浮肿 恶心 盗汗
防风 当归 牛膝 川乌 川芎 附子 麻黄 羌活 甘草 独活	半身不遂 瘫痪 四肢麻木 骨痛 咳嗽 腹痛 头痛 关节疼痛 呕吐 腰痛
当归 桃 川芎 桃仁 香附 红花 牛膝 赤芍 延胡索 肉桂	腹痛 咳嗽 头痛 呕吐 心烦 浮肿 腰痛 烦躁 恶心 盗汗
甘草 生姜 半夏 麻黄 桂枝 大枣 人参 葱白 芍药 竹沥	咳嗽 腹痛 头痛 呕吐 烦躁 壮热 心烦 痫 盗汗 恶寒
杏 杏仁 桑 紫菀 桑白皮 麻黄 款冬花 五味子 苦杏仁 紫苏子	咳嗽 头痛 呕吐 腹痛 壮热 烦躁 心烦 浮肿 短气 痫
桔梗 甘草 前胡 枳壳 陈皮 麻黄 柴胡 紫苏叶 旋覆花 葛根	咳嗽 头痛 呕吐 腹痛 烦躁 壮热 恶寒 心烦 鼻塞 恶心
牛膝 菟丝子 杜仲 五味子 山药 当归 熟地黄 枸杞子 茯苓 肉苁蓉	头晕 健忘 腰痛 盗汗 咳嗽 腹痛 心悸 头痛 目昏 心烦
半夏 厚朴 陈皮 苍术 藿香 生姜 甘草 茯苓 枳实 木瓜	咳嗽 头痛 腹痛 呕吐 恶寒 浮肿 壮热 烦躁 恶心 目昏
黄芩 芍药 柴胡 赤芍 石膏 甘草 葛根 升麻 知母 栀子	咳嗽 头痛 腹痛 壮热 呕吐 烦躁 痫 潮热 恶寒 心烦
石膏 犀角 升麻 甘草 麦门冬 羚羊角 大黄 黄芩 玄参 寒水石	头痛 咳嗽 腹痛 壮热 痫 呕吐 心烦 烦躁 恶寒 潮热
甘草 人参 茯苓 白术 半夏 陈皮 炙甘草 知母 沙棘 芒硝	咳嗽 腹痛 呕吐 头痛 恶心 壮热 烦躁 痫 心烦 目昏
茯苓 泽泻 木通 滑石 甘草 车前 车前子 猪苓 茵陈 瞿麦	腹痛 咳嗽 头痛 呕吐 烦躁 浮肿 壮热 心烦 口渴 恶心
黄芩 黄连 大黄 栀子 黄柏 郁金 龙胆 甘草 枳实 苦参	咳嗽 腹痛 头痛 呕吐 烦躁 壮热 心烦 瘰疬 痫 口苦
人参 甘草 白术 茯苓 干姜 附子 半夏 炙甘草 柴胡 蜘蛛	咳嗽 腹痛 头痛 呕吐 壮热 恶心 烦躁 恶寒 心烦 目昏
巴豆 木香 大黄 三棱 青皮 莪术 槟榔 牵牛 甘遂 五灵脂	咳嗽 腹痛 呕吐 头痛 浮肿 恶心 痫 烦躁 壮热 积滞
木香 丁香 豆蔻 沉香 茴香 肉豆蔻 砂仁 诃子 白豆蔻 益智	腹痛 呕吐 咳嗽 头痛 恶心 浮肿 烦躁 吞酸 盗汗 壮热
朱砂 麝香 天麻 牛黄 僵蚕 白附子 天南星 全蝎 附子 雄黄	咳嗽 痫 慢惊 急惊 神昏 头痛 烦躁 呕吐 壮热 腹痛
附子 干姜 细辛 吴茱萸 乌头 川乌 肉桂 硫黄 草乌 白矾	腹痛 咳嗽 头痛 呕吐 恶心 腰痛 浮肿 壮热 烦躁 恶寒
柴胡 黄连 鳖甲 地骨皮 知母 秦艽 乌梅 胡黄连 使君子 芦荟	咳嗽 腹痛 头痛 呕吐 壮热 烦躁 潮热 盗汗 心烦 痫
神曲 陈皮 厚朴 山楂 香附 砂仁 麦芽 枳实 青皮 藿香	腹痛 咳嗽 呕吐 头痛 嘈杂 恶心 嗳气 吞酸 恶寒 口渴
