甘草 人参 当归 茯苓 白术 川芎 陈皮 芍药 黄芩 木香	腹痛 胎动不安 漏下 崩中 腰痛 崩漏 胁痛 胎漏 产后腹痛 寒热往来
甘草 当归 人参 茯苓 白术 川芎 半夏 黄芩 附子 白芍	口噤 痫 项强 角弓反张 四肢拘急 慢惊 急惊 恶露不下 弄舌 神昏
甘草 人参 茯苓 黄芩 当归 半夏 柴胡 白术 芍药 川芎	口苦 舌干 咽干 胁痛 寒热往来 耳聋 心烦 小便黄赤 咽喉痛 但热不寒
甘草 茯苓 当归 白术 人参 半夏 川芎 黄芩 陈皮 木香	呕吐 恶心 干呕 小儿呕吐 妊娠呕吐 舌麻 小儿青盲 转筋 背痛 自汗
甘草 人参 茯苓 当归 白术 川芎 黄芩 陈皮 半夏 防风	痫 慢惊 急惊 壮热 神昏 四肢抽搐 晕厥 口流涎 干呕 胎毒
甘草 当归 茯苓 人参 白术 川芎 半夏 陈皮 黄芩 柴胡	盗汗 潮热 自汗 消瘦 烦躁 心烦 小儿厌食 皮肤甲错 面色青 咳痰
甘草 茯苓 当归 人参 白术 黄芩 川芎 半夏 白芍 陈皮	吞酸 呕吐 恶心 嘈杂 嗳气 呃逆 胃痛 食欲不振 四肢抽搐 舌光
甘草 茯苓 人参 当归 白术 陈皮 木香 半夏 黄芩 大黄	咳嗽 气喘 鼻塞 妊娠咳嗽 鼻痒 恶心 乳房肿块 白睛红赤 带状疱疹 干呕
甘草 当归 茯苓 人参 白术 川芎 芍药 防风 半夏 黄芩	半身不遂 瘫痪 腰痛 骨痛 四肢疼痛 耳聋 头重 臂痛 呵欠 舌强
甘草 当归 茯苓 白术 人参 防风 川芎 附子 黄芩 木香	目昏 四肢麻木 杨梅疮 皮肤瘙痒 腰膝无力 关节疼痛 远视 粉刺 腰痛 湿疮
甘草 茯苓 当归 人参 白术 川芎 木香 芍药 陈皮 白芍	白带 赤白带 崩漏 腹冷 不孕 闭经 月经过多 半身不遂 小便浑浊 足热
甘草 茯苓 当归 人参 黄芩 大黄 白术 芍药 黄连 川芎	吐血 便血 鼻衄 咳嗽 咳血 尿血 鼻干 大便下血 烦躁 脱肛
甘草 茯苓 人参 当归 白术 附子 陈皮 芍药 木香 半夏	小便不利 腹满 浮肿 身重 发黄 小便不通 干呕 大便溏 短气 头重
甘草 茯苓 人参 当归 白术 川芎 黄芩 半夏 芍药 附子	头痛 壮热 咳嗽 鼻塞 烦躁 麻疹 鼻干 流泪 声音嘶哑 恶寒
甘草 人参 茯苓 当归 黄芩 白术 半夏 桔梗 黄连 防风	烦躁 神昏 谵语 发狂 口渴 舌强 痫 不寐 头汗 唇肿
甘草 茯苓 当归 人参 白术 木香 川芎 半夏 陈皮 防风	腹痛 呕吐 转筋 恶心 手足厥冷 头痛 头晕 胸闷 头昏 上吐下泻
甘草 茯苓 当归 人参 白术 白芍 黄芩 柴胡 半夏 芍药	心烦 咽干 五心烦热 口渴 潮热 寒热往来 舌苔黄 舌苔黄腻 头昏 善怒
甘草 当归 黄芩 防风 川芎 茯苓 黄连 人参 大黄 桔梗	瘰疬 无名肿毒 牙痛 臁疮 丹毒 流泪 胎毒 痄腮 胬肉攀睛 杨梅疮
甘草 茯苓 当归 人参 白术 黄芩 川芎 半夏 白芍 柴胡	咳嗽 烦躁 口渴 麻疹 潮热 小儿发热 壮热 气喘 耳痛 声音嘶哑
甘草 当归 茯苓 人参 白术 川芎 木香 防风 芍药 陈皮	浮肿 咳嗽 瘰疬 难产 胞衣不下 多唾 产后血崩 产后浮肿 腹痛 乳汁不行
甘草 茯苓 当归 人参 白术 附子 川芎 芍药 干姜 五味子	腰痛 耳聋 盗汗 自汗 小便频数 不孕 遗尿 健忘 头晕 头昏
甘草 茯苓 当归 人参 白术 川芎 陈皮 白芍 黄芩 半夏	头晕 心悸 健忘 食欲不振 多梦 疲乏 畏寒 头昏 胸闷 须发早白
甘草 茯苓 当归 人参 白术 半夏 陈皮 附子 大黄 木香	腹痛 积滞 疳积 反胃 噎膈 腹满 心下痞 脱肛 消瘦 浮肿
甘草 当归 人参 白术 茯苓 半夏 陈皮 黄芩 附子 芍药	头痛 壮热 恶风 寒战 偏头痛 四肢疼痛 面痛 痱子 面色红 善食易饥
甘草 当归 茯苓 人参 白术 陈皮 黄芩 半夏 防风 桔梗	腹痛 呕吐 小便不通 大便秘结 口臭 腹泻 积滞 舌干 咽肿 小儿口疮
甘草 当归 茯苓 人参 白术 芍药 附子 川芎 半夏 陈皮	腹痛 肠鸣 里急后重 面色青 腹冷 转筋 少腹痛 消瘦 小便清长 大便溏
甘草 茯苓 当归 人参 白术 陈皮 半夏 芍药 柴胡 防风	恶寒 无汗 头痛 身痛 恶寒发热 恶风 项强 头重 产后发热 头汗
甘草 茯苓 当归 人参 白术 黄芩 附子 川芎 半夏 芍药	头痛 鼻塞 咳嗽 头昏 身重 项强 喷嚏 咽喉痛 恶寒 鼻痛
甘草 茯苓 人参 当归 半夏 白术 陈皮 黄芩 桔梗 枳壳	咳嗽 气喘 胸闷 舌苔白 麻疹 胸痛 咳痰 畏寒 喉痒 肥胖
甘草 人参 茯苓 当归 白术 半夏 附子 芍药 防风 黄芩	短气 少气 浮肿 恶风 背痛 自汗 小便不利 四肢疼痛 腰脊痛 腰重
