角色0 ： 麦门冬 天门冬 生地黄 五味子 熟地黄 人参 芍药 知母 石菖蒲 土茯苓  角色1 ： 远志 酸枣仁 柏子仁 石菖蒲 龙齿 五味子 琥珀 犀角 卷柏 白术  角色2 ： 人参 五味子 麦门冬 茯苓 远志 大枣 木通 知母 天麻 阿胶  角色3 ： 远志 人参 五味子 麦门冬 石菖蒲 丹参 山药 生地黄 甘草 山茱萸	健忘 短气 心烦 盗汗 自汗 耳聋 咳嗽 痫 心悸 多梦
角色0 ： 薄荷 荷叶 柴胡 山豆根 防风 附子 前胡 枳实 天花粉 蜈蚣  角色1 ： 甘草 黄芩 桔梗 枳壳 葛根 枳实 防己 防风 羌活 诃子  角色2 ： 甘草 黄芩 桔梗 当归 知母 皂荚 麦门冬 前胡 人参 胆矾  角色3 ： 甘草 桔梗 枳壳 柴胡 木通 香附 乌梅 白术 五灵脂 泽泻	咳嗽 鼻干 头痛 壮热 气喘 腹痛 烦躁 咽喉痛 胸闷 舌疮
角色0 ： 木香 槟榔 青皮 陈皮 牵牛 雷丸 五灵脂 三棱 斑蝥 琥珀  角色1 ： 三棱 莪术 青皮 干漆 阿魏 巴豆 萝卜 青木香 香附 姜黄  角色2 ： 巴豆 甘遂 大黄 芫花 大戟 五灵脂 牵牛 斑蝥 干漆 巴豆霜  角色3 ： 木香 槟榔 枳壳 青皮 大黄 党参 牛膝 黄连 防己 玄参	腹痛 腹满 消瘦 里急后重 积滞 瘰疬 小便不通 噎膈 胃痛 目昏
角色0 ： 菟丝子 鹿茸 肉苁蓉 蛇床子 枸杞子 覆盆子 补骨脂 五味子 巴戟天 淫羊藿  角色1 ： 石斛 山茱萸 五味子 肉苁蓉 磁石 牛膝 远志 菟丝子 巴戟天 柏子仁  角色2 ： 山药 杜仲 鹿角 鹿角胶 山茱萸 牛膝 枸杞子 菟丝子 鹿角霜 补骨脂  角色3 ： 牛膝 杜仲 续断 狗脊 补骨脂 山药 泽泻 丹参 莲须 连翘	腰痛 耳聋 目昏 头晕 不孕 白带 腰膝无力 小便频数 盗汗 胎动不安
角色0 ： 茯苓 泽泻 白术 猪苓 黄柏 商陆 生姜 大麦 苍术 五味子  角色1 ： 益智 白术 茯苓 益智仁 甘草 陈皮 山药 麦门冬 赤芍 竹茹  角色2 ： 茯苓 甘草 白术 枳壳 木通 肉桂 鸡子 茵陈 川楝子 黄芩  角色3 ： 泽泻 茵陈 猪苓 木通 茯苓 防己 茵陈蒿 枳实 苦参 陈皮	小便不利 发黄 小便黄赤 呕吐 小便频数 舌苔黄 遗尿 自汗 舌苔黄腻 壮热
角色0 ： 木香 丁香 沉香 青木香 柿蒂 母丁香 瓜蒌 檀香 栀子 人参  角色1 ： 砂仁 木香 香附 乌药 姜黄 白芷 佛手 片姜黄 郁金 厚朴  角色2 ： 丁香 沉香 藿香 檀香 甘松 零陵香 苏合香 母丁香 朱砂 松香  角色3 ： 香附 陈皮 砂仁 乌药 青皮 芍药 姜黄 白豆蔻 党参 芦根	恶心 呕吐 腹痛 吞酸 呃逆 嗳气 胃痛 小儿呕吐 胎动不安 产后腹痛
角色0 ： 甘草 茯苓 人参 白术 枳实 黄连 陈皮 轻粉 虎杖 党参  角色1 ： 甘草 乌梅 人参 当归 绿豆 细辛 百草霜 牛膝 知母 白芍  角色2 ： 甘草 人参 麦门冬 茯苓 远志 延胡索 川芎 硫黄 姜黄 白芍  角色3 ： 茯苓 人参 甘草 半夏 麦门冬 乌梅 白术 枳壳 陈皮 石膏	舌干 口苦 心烦 腹痛 咳嗽 呕吐 气喘 烦躁 心悸 口渴
角色0 ： 乳香 没药 轻粉 穿山甲 血竭 五灵脂 白矾 麝香 海桐皮 炉甘石  角色1 ： 白芷 白及 乳香 白蔹 蓖麻 五倍子 松香 蓖麻子 穿山甲 樟脑  角色2 ： 川乌 草乌 乌头 五灵脂 地龙 木鳖子 自然铜 骨碎补 何首乌 威灵仙  角色3 ： 乳香 没药 血竭 轻粉 麝香 雄黄 儿茶 冰片 海螵蛸 自然铜	无名肿毒 臁疮 瘰疬 瘫痪 半身不遂 白带 骨痛 杨梅疮 赤白带 吐血
角色0 ： 大黄 黄芩 栀子 木通 甘草 麻黄 犀角 茵陈 泽泻 蒲黄  角色1 ： 滑石 木通 瞿麦 冬葵 冬葵子 石韦 黄芩 猪苓 白茅根 通草  角色2 ： 竹叶 淡竹 淡竹叶 甘草 木通 连翘 栀子 通草 黄芩 侧柏叶  角色3 ： 滑石 木通 大黄 甘草 寒水石 绿豆 滑石粉 通草 天南星 儿茶	小便不通 小便不利 壮热 大便秘结 腹痛 谵语 口渴 慢惊 咽肿 头痛
角色0 ： 杏仁 杏 麻黄 紫苏子 人参 阿胶 黄柏 肉苁蓉 苦杏仁 桑白皮  角色1 ： 杏 杏仁 苦杏仁 紫苏叶 紫苏子 葶苈子 浙贝母 大黄 白果 马兜铃  角色2 ： 杏 杏仁 麻黄 紫菀 天花粉 皂荚 白石英 五味子 百部 黄芩  角色3 ： 杏 杏仁 麻黄 人参 寒水石 海螵蛸 桔梗 苦杏仁 生地黄 桂枝	咳嗽 恶寒 气喘 无汗 耳聋 头痛 浮肿 痫 胸闷 恶寒发热
角色0 ： 牡蛎 龙骨 赤石脂 麻黄根 白术 艾叶 海螵蛸 寒水石 龟甲 磁石  角色1 ： 干姜 附子 当归 硫黄 白芍 大黄 龙骨 吴茱萸 甜瓜 酸枣仁  角色2 ： 赤石脂 龙骨 牡蛎 赭石 禹余粮 紫石英 鹿茸 代赭石 附子 阳起石  角色3 ： 白矾 硫黄 附子 铅丹 阳起石 龙骨 诃子 蛇床子 桂枝 赤小豆	盗汗 赤白带 白带 崩中 痫 自汗 脱肛 漏下 头晕 崩漏
角色0 ： 当归 白芍 芍药 川芎 生地黄 白薇 白矾 阿胶 生姜 葫芦  角色1 ： 阿胶 当归 蒲黄 地榆 槐花 侧柏叶 小蓟 藕节 黄连 荷叶  角色2 ： 当归 白芍 川芎 黄芩 芍药 熟地黄 人参 藕节 泽泻 地榆  角色3 ： 阿胶 艾叶 地榆 续断 槐角 鸡子 白芍 旋覆花 栀子 黄芩	吐血 便血 腹痛 赤白带 白带 崩漏 胎动不安 胎漏 尿血 心烦
角色0 ： 茯苓 甘草 人参 白术 半夏 大黄 川芎 附子 荆芥 姜黄  角色1 ： 甘草 茯苓 人参 白术 半夏 白薇 枳壳 当归 细辛 槐花  角色2 ： 白术 人参 茯苓 枳实 白芍 芍药 甘草 郁金 白芷 柏子仁  角色3 ： 甘草 白术 茯苓 人参 大豆 乌药 大黄 白薇 升麻 麦门冬	少气 腹痛 腹满 干呕 呕吐 小便不利 自汗 咳嗽 气喘 舌干
角色0 ： 人参 半夏 茯苓 甘草 枳壳 竹茹 竹沥 山茱萸 桉油 巴豆  角色1 ： 陈皮 茯苓 半夏 甘草 当归 枳壳 大腹皮 竹沥 桔梗 炙甘草  角色2 ： 甘草 人参 茯苓 枳实 木香 旋覆花 龙齿 枳壳 竹沥 芜荑  角色3 ： 半夏 枳实 陈皮 橘红 白术 瓜蒌 茯苓 竹茹 甘草 木香	呕吐 腹满 咳嗽 心下痞 气喘 恶心 噎膈 咽干 反胃 头昏
角色0 ： 甘草 人参 干姜 当归 柴胡 厚朴 附子 姜黄 白芍 阿魏  角色1 ： 人参 茯苓 甘草 白术 陈皮 干姜 当归 竹叶 细辛 瞿麦  角色2 ： 人参 甘草 白术 茯苓 半夏 柴胡 枳壳 细辛 黄连 萝卜  角色3 ： 白术 甘草 茯苓 炙甘草 人参 川芎 竹茹 紫草 肉苁蓉 铅丹	口噤 腹痛 咳嗽 呕吐 壮热 气喘 自汗 阴疮 角弓反张 口淡
角色0 ： 生姜 半夏 厚朴 人参 枳实 瓜蒂 木香 乌梅 茯苓 紫苏子  角色1 ： 半夏 生姜 厚朴 附子 竹茹 橘红 高良姜 白扁豆 天南星 浮萍  角色2 ： 生姜 大枣 桂枝 小麦 浮小麦 桑 赤小豆 饴糖 竹沥 羚羊角  角色3 ： 生姜 半夏 葱白 厚朴 桂枝 茯苓 皂荚 芦根 槟榔 甘草	呕吐 恶寒 头痛 咳嗽 鼻塞 反胃 恶寒发热 臂痛 恶心 脏躁
角色0 ： 大黄 黄芩 栀子 龙胆 甘草 商陆 木通 蒲黄 沙参 葱白  角色1 ： 犀角 升麻 钩藤 龙齿 蛇蜕 牛黄 蜂房 大黄 白鲜皮 羚羊角  角色2 ： 犀角 羚羊角 升麻 玄参 麦门冬 龙胆 丁香 厚朴 川芎 白芍  角色3 ： 车前 车前子 木通 车前草 黄连 冬瓜 竹沥 附子 柴胡 沉香	壮热 痫 烦躁 心烦 口苦 头痛 咳嗽 小便不利 耳聋 急惊
角色0 ： 石膏 升麻 葛根 知母 麦门冬 麻黄 玄参 皂荚 延胡索 芍药  角色1 ： 石膏 麻黄 寒水石 甘草 黄芩 柴胡 葱白 熟地黄 地龙 生地黄  角色2 ： 石膏 升麻 葛根 柴胡 知母 芍药 鳖甲 防风 麻黄 肉桂  角色3 ： 石膏 麻黄 黄芩 葛根 知母 葱白 麦门冬 升麻 苍术 栀子	头痛 壮热 口渴 心烦 咽干 恶寒 谵语 自汗 发狂 牙痛
角色0 ： 川芎 香附 白芍 益母草 熟地黄 延胡索 乌药 牛膝 红花 葫芦  角色1 ： 当归 川芎 白芍 香附 赤小豆 五灵脂 薤白 秦艽 茜草 白矾  角色2 ： 当归 白芍 川芎 香附 芍药 炙甘草 红花 滑石 炮姜 麦门冬  角色3 ： 当归 白芍 川芎 香附 皂荚 甘草 麦门冬 荆芥 黄柏 干姜	腹痛 难产 头痛 自汗 盗汗 崩漏 胁痛 嗳气 漏下 吞酸
角色0 ： 神曲 山楂 麦芽 砂仁 谷芽 鸡内金 莱菔子 苍术 泽泻 法半夏  角色1 ： 陈皮 砂仁 青皮 厚朴 香附 草果 枳实 白芷 苍术 麦门冬  角色2 ： 神曲 山楂 麦芽 枳实 苍术 厚朴 莱菔子 青皮 鸡内金 香附  角色3 ： 陈皮 香附 苍术 枳实 厚朴 砂仁 大麦 白芍 神曲 白术	恶心 嘈杂 吞酸 腹痛 食欲不振 腹满 大便秘结 嗳气 积滞 呕吐
角色0 ： 连翘 桔梗 薄荷 荆芥 蝉蜕 紫草 赤芍 苦参 马勃 紫草茸  角色1 ： 牛蒡 牛蒡子 荆芥 薄荷 桔梗 连翘 淡豆豉 大青叶 天花粉 瓜蒌  角色2 ： 玄参 升麻 射干 连翘 犀角 夏枯草 海藻 昆布 漏芦 龙胆  角色3 ： 连翘 金银花 天花粉 玄参 板蓝根 蒲公英 黄芩 大青叶 皂角刺 水牛角	瘰疬 麻疹 谵语 丹毒 咳嗽 头痛 痄腮 神昏 咽喉痛 口渴
角色0 ： 白芷 川芎 细辛 苍术 羌活 藁本 薏苡仁 蜈蚣 何首乌 香薷  角色1 ： 白芷 薄荷 川芎 荆芥 防风 苍耳 细辛 苍耳子 羌活 藁本  角色2 ： 防风 白芷 荆芥 川芎 细辛 羌活 赤芍 独活 诃子 蛤蚧  角色3 ： 细辛 白芷 藁本 川芎 蔓荆子 羌活 防风 桔梗 菊花 大黄	头痛 鼻塞 白带 牙痛 骨痛 麻疹 身重 身痛 无汗 恶寒
角色0 ： 茯苓 甘草 人参 陈皮 半夏 厚朴 当归 白芍 麦门冬 干姜  角色1 ： 甘草 茯苓 白术 人参 乌梅 炙甘草 竹茹 陈皮 穿心莲 乳香  角色2 ： 茯苓 人参 白术 当归 甘草 附子 干姜 厚朴 肉桂 枳壳  角色3 ： 甘草 白术 人参 白芍 硫黄 薤白 冰片 神曲 石斛 乌头	干呕 腹痛 消瘦 背痛 短气 咳嗽 呕吐 少气 自汗 气喘
角色0 ： 羌活 防风 白芷 苍术 麻黄 独活 当归 附子 青木香 甘草  角色1 ： 防风 羌活 川芎 独活 天麻 麻黄 附子 枳壳 白鲜皮 赤石脂  角色2 ： 川芎 防风 荆芥 羌活 陈皮 柴胡 薄荷 天麻 桔梗 赤小豆  角色3 ： 麻黄 细辛 独活 防风 桂枝 桔梗 葛根 白鲜皮 苍术 炙甘草	头痛 恶寒 无汗 项强 身痛 恶寒发热 浮肿 鼻塞 咳嗽 麻疹
角色0 ： 防风 荆芥 羌活 菊花 苦参 磁石 赤小豆 百草霜 黄芩 钩藤  角色1 ： 藜 蒺藜 石决明 木贼 藜芦 青葙 决明子 青葙子 蝉蜕 茺蔚子  角色2 ： 防风 细辛 羌活 苦参 木香 柴胡 海螵蛸 地肤子 地骨皮 薄荷  角色3 ： 菊花 羚羊角 防风 旋覆花 蔓荆子 苦参 野菊花 栀子 夏枯草 花椒	目昏 头痛 流泪 皮肤瘙痒 鼻塞 远视 拳毛倒睫 麻疹 牙痛 身痛
角色0 ： 附子 白附子 天南星 天麻 僵蚕 全蝎 麝香 蜈蚣 琥珀 白矾  角色1 ： 白附子 附子 天南星 僵蚕 天麻 全蝎 犀角 安息香 珍珠 威灵仙  角色2 ： 天麻 僵蚕 全蝎 天竺黄 钩藤 胆南星 蝉蜕 朱砂 牛胆 琥珀  角色3 ： 全蝎 麝香 朱砂 僵蚕 天麻 蜈蚣 雄黄 赭石 甘草 冬瓜子	慢惊 痫 半身不遂 头痛 咳嗽 角弓反张 瘰疬 皮肤瘙痒 神昏 四肢抽搐
角色0 ： 青黛 麝香 黄连 朱砂 硼砂 人中白 黄柏 五灵脂 山豆根 麻黄  角色1 ： 黄连 青黛 龙胆 黄柏 郁金 犀角 牛黄 白术 柴胡 玄明粉  角色2 ： 巴豆 皂荚 轻粉 猪牙皂 雄黄 巴豆霜 麝香 百草霜 五灵脂 朱砂  角色3 ： 黄连 胡黄连 芦荟 使君子 芜荑 熊胆 雷丸 鹤虱 夜明砂 瓜蒂	烦躁 疳积 口臭 潮热 心烦 臁疮 痫 盗汗 丹毒 神昏
角色0 ： 木香 槟榔 大黄 枳壳 青皮 枳实 沉香 萝卜 桑 白茅根  角色1 ： 木香 大腹皮 枳壳 槟榔 木通 防己 大黄 当归 甘草 木瓜  角色2 ： 牵牛 郁李 郁李仁 槟榔 牵牛子 防己 泽漆 甘遂 赤小豆 桔梗  角色3 ： 大黄 槟榔 木香 枳壳 赤小豆 冬瓜 黄连 赤芍 大蒜 商陆	浮肿 腹痛 里急后重 积滞 大便秘结 小便不利 鼻衄 腰痛 腹满 转筋
角色0 ： 芍药 赤芍 当归 甘草 葱白 红花 木通 桔梗 虎杖 栀子  角色1 ： 芍药 赤芍 犀角 黄柏 陈皮 黄芩 杜仲 蒲黄 麦门冬 牛膝  角色2 ： 芍药 赤芍 当归 黄芩 细辛 羚羊角 青黛 花蕊石 枳壳 绿豆  角色3 ： 赤芍 芍药 当归 生地黄 桂枝 大黄 细辛 白茅根 地龙 太子参	鼻衄 四肢疼痛 腹痛 吐血 烦躁 胁痛 舌肿 壮热 小儿口疮 舌卷
角色0 ： 甘草 人参 茯苓 炙甘草 半夏 附子 白术 三七 芍药 地榆  角色1 ： 白术 甘草 人参 半夏 茯苓 炙甘草 乌梅 柴胡 枳壳 雄黄  角色2 ： 甘草 炙甘草 半夏 陈皮 桂枝 肉桂 升麻 附子 乌梅 葛根  角色3 ： 白术 人参 茯苓 甘草 陈皮 干姜 沉香 木香 茵陈 荆芥	恶风 腹痛 头重 咳嗽 口噤 自汗 呕吐 气喘 小便不利 身重
角色0 ： 丁香 木香 胡椒 高良姜 荜茇 阿魏 母丁香 诃子 荜澄茄 香附  角色1 ： 豆蔻 丁香 白豆蔻 肉豆蔻 木香 沉香 诃子 荜澄茄 安息香 砂仁  角色2 ： 茴香 木香 沉香 小茴香 川楝子 葫芦 胡芦巴 吴茱萸 八角茴香 阿魏  角色3 ： 豆蔻 肉豆蔻 草豆蔻 诃子 高良姜 白豆蔻 肉桂 枳壳 天门冬 人参	肠鸣 呕吐 腹痛 腰痛 腹冷 呃逆 吞酸 口臭 恶心 牙痛
角色0 ： 前胡 桔梗 枳壳 半夏 甘草 陈皮 紫苏叶 郁金 当归 麦门冬  角色1 ： 前胡 枳壳 桔梗 半夏 旋覆花 鳖甲 瓜蒌 通草 赤芍 马兜铃  角色2 ： 桔梗 枳壳 前胡 半夏 陈皮 茯苓 旋覆花 法半夏 大腹皮 瓜蒌  角色3 ： 甘草 枳壳 前胡 桔梗 葛根 槐角 生地黄 川贝母 木通 桑	咳嗽 壮热 呕吐 舌苔白 心下痞 胸闷 多唾 反胃 胁痛 气喘
角色0 ： 黄芩 大黄 栀子 黄连 黄柏 丹参 贯众 枳实 威灵仙 苦参  角色1 ： 黄连 黄芩 栀子 大黄 黄柏 龙胆 郁金 枳实 苍术 秦皮  角色2 ： 黄柏 黄连 黄芩 知母 生地黄 瓜蒂 乌梅 枳壳 赭石 益智  角色3 ： 黄芩 栀子 黄柏 黄连 甘草 苦参 菊花 龙胆 花椒 犀角	烦躁 心烦 头痛 盗汗 牙痛 呕吐 咳嗽 口苦 不寐 神昏
角色0 ： 山药 茯苓 莲子 芡实 泽泻 薏苡仁 白扁豆 莲子心 党参 当归  角色1 ： 党参 黄芪 熟地黄 山药 丹参 龙眼 枸杞子 龙眼肉 紫河车 炙甘草  角色2 ： 何首乌 女贞 女贞子 熟地黄 菟丝子 枸杞子 黄精 金樱子 制何首乌 桑椹  角色3 ： 桑 桑寄生 桑叶 桑螵蛸 桑枝 羚羊角 白薇 葱白 忍冬藤 黄芩	头晕 白带 心悸 头昏 咽干 目昏 健忘 潮热 浮肿 须发早白
角色0 ： 桃 桃仁 大黄 水蛭 虻虫 红花 鬼箭羽 紫草 安息香 百合  角色1 ： 丹参 郁金 当归 三七 川芎 茜草 降香 橘红 赤小豆 百草霜  角色2 ： 桃 桃仁 红花 核桃仁 鳖甲 姜黄 红粉 当归 铅丹 苏木  角色3 ： 当归 红花 延胡索 泽兰 蒲黄 苏木 赤芍 川芎 刘寄奴 大黄	腹痛 烦躁 吐血 胸痛 胸闷 崩中 心烦 恶露不下 腰重 发狂
角色0 ： 当归 生地黄 芍药 白芍 防风 琥珀 川芎 升麻 赤小豆 泽兰  角色1 ： 当归 白芍 川芎 生地黄 白术 黄柏 柴胡 骨碎补 茯苓 荆芥  角色2 ： 当归 芍药 白芍 川芎 山药 茯苓 陈皮 远志 熟地黄 桔梗  角色3 ： 牡丹 牡丹皮 延胡索 熟地黄 山茱萸 泽泻 白薇 生地黄 栀子 柴胡	腹痛 赤白带 吐血 五心烦热 大便下血 消瘦 少气 潮热 头痛 盗汗
角色0 ： 朱砂 麝香 雄黄 牛黄 天竺黄 琥珀 蟾酥 青礞石 栀子 川乌  角色1 ： 冰片 珍珠 牛黄 琥珀 硼砂 郁金 麝香 熊胆 炉甘石 玄明粉  角色2 ： 麝香 朱砂 雄黄 牛黄 蟾酥 冰片 青礞石 黄连 血竭 青黛  角色3 ： 麝香 朱砂 雄黄 牛黄 冰片 天竺黄 琥珀 水牛角 胆矾 川贝母	痫 急惊 神昏 瘰疬 腹痛 难产 发狂 目昏 心烦 谵语
角色0 ： 防风 防己 独活 木瓜 白鲜皮 秦艽 土茯苓 细辛 薏苡仁 羌活  角色1 ： 五加 牛膝 五加皮 独活 羚羊角 薏苡仁 防风 海桐皮 酸枣仁 当归  角色2 ： 防风 羌活 麻黄 独活 秦艽 防己 羚羊角 瓜蒌 闹羊花 三七  角色3 ： 牛膝 威灵仙 木瓜 桂枝 草乌 秦艽 川乌 红花 独活 虎骨	口噤 杨梅疮 四肢麻木 转筋 瘫痪 四肢拘急 浮肿 角弓反张 恶寒 半身不遂
角色0 ： 五味子 紫菀 款冬花 罂粟 罂粟壳 乌梅 白石英 麦门冬 防己 干姜  角色1 ： 紫菀 款冬花 百部 百合 天门冬 白前 桔梗 知母 马兜铃 蛤蚧  角色2 ： 桑 橘红 桔梗 瓜蒌 川贝母 桑白皮 法半夏 紫苏叶 化橘红 紫苏子  角色3 ： 桑 桑白皮 马兜铃 赤小豆 紫菀 桑寄生 青皮 滑石 地龙 生姜	咳嗽 短气 浮肿 气喘 咳血 胸闷 喉痒 自汗 盗汗 咽干
角色0 ： 麦冬 玄参 桔梗 天花粉 知母 瓜蒌 黄芩 黄柏 山豆根 浙贝母  角色1 ： 沙参 芥子 麦冬 白芥 白芥子 北沙参 川贝母 石斛 丹参 南沙参  角色2 ： 麦冬 天冬 知母 百合 萝卜 石斛 天门冬 葫芦 樟脑 苍术  角色3 ： 枇杷 枇杷叶 竹茹 芦根 橘红 前胡 梨 石斛 薄荷 桑叶	咳嗽 口渴 咽干 心烦 吐血 潮热 呕吐 咳痰 咳血 瘰疬
角色0 ： 甘草 黄芩 柴胡 枳壳 犀角 藁本 斑蝥 炙甘草 朱砂 刘寄奴  角色1 ： 黄芩 甘草 大黄 柴胡 芍药 枳壳 葛根 升麻 犀角 龙胆  角色2 ： 柴胡 黄芩 升麻 甘草 僵蚕 羚羊角 大豆 郁金 麦门冬 紫石英  角色3 ： 甘草 柴胡 黄芩 黄连 大黄 升麻 郁金 当归 大麦 苦参	壮热 烦躁 头痛 寒热往来 咳嗽 胁痛 气喘 脱肛 寒战 腹痛
角色0 ： 柴胡 地骨皮 知母 麦门冬 芍药 犀角 大黄 郁金 银柴胡 防己  角色1 ： 柴胡 鳖甲 秦艽 青蒿 常山 知母 麦门冬 桔梗 竹沥 茵陈蒿  角色2 ： 柴胡 鳖甲 知母 地骨皮 秦艽 人参 生地黄 银柴胡 半夏 大黄  角色3 ： 甘草 地骨皮 麦门冬 人参 犀角 芍药 黄柏 羚羊角 泽泻 赤芍	潮热 盗汗 寒热往来 心烦 五心烦热 胁痛 咳嗽 口苦 头痛 吐血
角色0 ： 附子 干姜 吴茱萸 苦参 川乌 厚朴 人参 续断 阿魏 前胡  角色1 ： 干姜 吴茱萸 附子 细辛 皂荚 川贝母 五灵脂 大麦 青木香 泽兰  角色2 ： 乌头 附子 干姜 川乌 细辛 大豆 当归 天南星 沙参 寒水石  角色3 ： 附子 干姜 吴茱萸 细辛 麻黄 赤小豆 神曲 甘草 川芎 黄连	呕吐 手足厥冷 面色青 腹冷 腹痛 吞酸 少气 鼻塞 背痛 口噤
角色0 ： 藿香 厚朴 木瓜 香薷 广藿香 紫苏叶 白扁豆 槟榔 大腹皮 檀香  角色1 ： 厚朴 苍术 藿香 陈皮 半夏 草果 砂仁 当归 竹茹 使君子  角色2 ： 陈皮 厚朴 苍术 半夏 甘草 枳实 砂仁 神曲 高良姜 巴豆  角色3 ： 陈皮 半夏 白术 甘草 石榴 苍术 石榴皮 黄连 黄芩 法半夏	呕吐 转筋 恶心 恶寒 身重 头痛 腹泻 腹痛 上吐下泻 咳嗽
角色0 ： 甘草 肉桂 茯苓 白术 生地黄 半夏 炙甘草 益母草 人参 炮姜  角色1 ： 当归 肉桂 白术 炮姜 炙甘草 川芎 白薇 大豆 天南星 木香  角色2 ： 当归 人参 肉桂 干姜 甘草 茯苓 桂枝 射干 炙甘草 芍药  角色3 ： 人参 白术 甘草 附子 当归 肉桂 茯苓 竹沥 厚朴 生姜	腹痛 浮肿 短气 畏寒 腰痛 头晕 气喘 自汗 不孕 小便不利
