人参 甘草 白术 茯苓 炙甘草 白芍 麦冬 当归 五味子 麦门冬	自汗 短气 盗汗 少气 口苦 恶风 畏寒 身重 消瘦 头重
杏 杏仁 桑 紫菀 桑白皮 麻黄 五味子 款冬花 桔梗 百合	咳嗽 气喘 咳痰 喉痒 妊娠咳嗽 哮鸣 胎毒 嗜睡 四肢疼痛 背痛
防风 独活 羌活 川乌 麻黄 附子 乌头 牛膝 草乌 秦艽	口噤 半身不遂 瘫痪 项强 骨痛 角弓反张 四肢拘急 四肢麻木 舌强 四肢疼痛
当归 芍药 生地黄 阿胶 龙骨 白芍 牡丹 牡丹皮 赤石脂 牡蛎	吐血 鼻衄 便血 崩中 漏下 崩漏 尿血 大便下血 咳血 脱肛
当归 白芍 川芎 香附 白术 陈皮 阿胶 熟地黄 肉桂 乌药	白带 赤白带 腹痛 胎动不安 不孕 胎漏 崩漏 难产 头热 经行腹痛
甘草 柴胡 人参 麦门冬 茯苓 知母 地骨皮 鳖甲 芍药 秦艽	心烦 潮热 盗汗 五心烦热 烦躁 寒热往来 咽干 四肢疼痛 消瘦 但热不寒
半夏 茯苓 白术 甘草 生姜 陈皮 人参 厚朴 藿香 枳实	呕吐 恶心 干呕 腹满 心下痞 大便溏 身重 反胃 口淡 小儿呕吐
干姜 附子 人参 白术 吴茱萸 细辛 甘草 厚朴 生姜 肉桂	腹痛 短气 腹满 手足厥冷 肠鸣 面色青 少气 背痛 转筋 干呕
枇杷叶 枇杷 甘草 黄芩 桔梗 麦冬 薄荷 瓜蒌 芦根 板蓝根	咳嗽 胸闷 头痛 呕吐 吐血 口渴 咽干 气喘 舌苔白 腹泻
防风 白芷 川芎 羌活 细辛 荆芥 菊花 藜 藁本 蒺藜	头痛 目昏 鼻塞 头昏 皮肤瘙痒 流泪 身痛 偏头痛 喷嚏 拳毛倒睫
黄芪 山药 鹿角 何首乌 党参 熟地黄 枸杞子 麦冬 女贞 女贞子	头晕 心悸 健忘 胸闷 多梦 食欲不振 自汗 头昏 盗汗 心烦
甘草 半夏 桔梗 枳壳 茯苓 前胡 陈皮 旋覆花 橘红 紫苏叶	咳嗽 头痛 鼻塞 气喘 目昏 胁痛 多唾 壮热 妊娠咳嗽 鼻衄
木通 茯苓 泽泻 滑石 车前 车前子 槟榔 猪苓 牵牛 防己	浮肿 小便不利 小便不通 气喘 腹满 妊娠小便不通 产后浮肿 尿痛 口渴 耳聋
当归 木香 附子 丁香 细辛 乳香 川乌 白芷 芍药 麝香	腹痛 瘰疬 头痛 痫 神昏 便血 脱肛 浮肿 吐血 崩漏
当归 赤芍 桃 芍药 桃仁 红花 川芎 大黄 丹参 延胡索	腹痛 胁痛 腰痛 难产 寒热往来 四肢疼痛 恶露不下 腹满 胞衣不下 胸痛
升麻 石膏 甘草 黄芩 麦门冬 犀角 芍药 赤芍 葛根 柴胡	壮热 头痛 烦躁 舌干 咽喉痛 鼻干 唇肿 耳聋 舌疮 口中生疮
黄连 木香 大黄 巴豆 槟榔 乌梅 青黛 甘草 枳壳 胡黄连	腹痛 壮热 里急后重 疳积 消瘦 口臭 积滞 脱肛 潮热 大便秘结
朱砂 麝香 牛黄 僵蚕 天麻 白附子 全蝎 天南星 附子 雄黄	痫 慢惊 急惊 神昏 口噤 角弓反张 四肢抽搐 弄舌 呵欠 足热
连翘 薄荷 桔梗 甘草 麦冬 荆芥 玄参 黄芩 牛蒡 牛蒡子	口渴 麻疹 咽干 丹毒 烦躁 谵语 杨梅疮 舌干 神昏 咽肿
木香 丁香 豆蔻 沉香 茴香 肉豆蔻 附子 藿香 白豆蔻 肉桂	呕吐 腹痛 恶心 肠鸣 腹冷 转筋 呃逆 吞酸 反胃 口臭
陈皮 青皮 神曲 厚朴 砂仁 香附 木香 山楂 三棱 苍术	呕吐 恶心 吞酸 嘈杂 积滞 嗳气 噎膈 腹痛 胃痛 反胃
乳香 没药 麝香 雄黄 冰片 轻粉 朱砂 巴豆 白矾 血竭	瘰疬 臁疮 无名肿毒 牙痛 杨梅疮 难产 湿疮 胎毒 粉刺 阴疮
黄芩 大黄 黄连 栀子 甘草 黄柏 柴胡 茵陈 郁金 龙胆	烦躁 口苦 发黄 舌干 谵语 心烦 大便秘结 发狂 壮热 小便黄赤
远志 五味子 杜仲 牛膝 山药 菟丝子 茯苓 山茱萸 石斛 肉苁蓉	腰痛 耳聋 盗汗 健忘 目昏 小便频数 不寐 遗尿 腰重 短气
甘草 麻黄 生姜 石膏 桂枝 芍药 大枣 葛根 半夏 苍术	恶寒 头痛 无汗 恶风 恶寒发热 身痛 项强 身重 牙痛 咳血
