角色0 ： 人参 白术 甘草 干姜 茯苓 当归 附子 香附 薤白 大麦  角色1 ： 干姜 附子 吴茱萸 细辛 乌头 硫黄 芍药 木香 丹参 远志  角色2 ： 附子 干姜 白术 肉桂 人参 茯苓 半夏 甘草 荜茇 石斛  角色3 ： 生姜 厚朴 吴茱萸 附子 干姜 高良姜 白术 木瓜 人参 槟榔	腹痛 少气 转筋 手足厥冷 肠鸣 腹冷 面色青 短气 背痛 腹满
角色0 ： 生姜 半夏 大枣 厚朴 桂枝 甘草 人参 薤白 葱白 白术  角色1 ： 人参 白术 甘草 半夏 茯苓 干姜 肉桂 天南星 五味子 芒硝  角色2 ： 人参 茯苓 半夏 白术 陈皮 甘草 大麦 檀香 石菖蒲 延胡索  角色3 ： 半夏 甘草 枳实 茯苓 人参 陈皮 橘红 竹茹 生姜 柿蒂	呕吐 短气 腹满 干呕 恶心 心下痞 呃逆 小儿呕吐 多唾 心下悸
角色0 ： 砂仁 香附 陈皮 木香 青皮 枳壳 厚朴 乌药 姜黄 草果  角色1 ： 陈皮 苍术 厚朴 半夏 香附 砂仁 枳壳 草果 甘草 白术  角色2 ： 藿香 陈皮 半夏 厚朴 苍术 香薷 木瓜 砂仁 白扁豆 广藿香  角色3 ： 神曲 山楂 麦芽 枳实 陈皮 青皮 莱菔子 砂仁 槟榔 香附	呕吐 恶心 吞酸 腹痛 嘈杂 胸闷 嗳气 腹泻 反胃 胃痛
角色0 ： 藜 菊花 蒺藜 防风 羚羊角 羌活 石决明 木贼 苦参 藜芦  角色1 ： 甘草 柴胡 黄芩 枳壳 茯苓 川芎 桔梗 白薇 升麻 三七  角色2 ： 芍药 赤芍 当归 甘草 地龙 柴胡 黄芩 忍冬藤 苍术 鸡子  角色3 ： 枳壳 前胡 甘草 桔梗 半夏 旋覆花 茯苓 大腹皮 白薇 陈皮	目昏 胁痛 耳聋 心烦 四肢疼痛 流泪 口苦 头重 寒热往来 皮肤瘙痒
角色0 ： 甘草 竹叶 麦门冬 石膏 淡竹 竹茹 淡竹叶 芦根 小麦 知母  角色1 ： 麦冬 玄参 沙参 天冬 知母 白芍 丹参 石斛 北沙参 地骨皮  角色2 ： 黄连 黄芩 黄柏 知母 生地黄 甘草 当归 天花粉 枳壳 猪苓  角色3 ： 甘草 人参 茯苓 益智 山药 益智仁 莲子 芡实 莲子心 紫河车	烦躁 口渴 心烦 咽干 吐血 不寐 谵语 遗尿 发狂 口臭
角色0 ： 大黄 黄芩 栀子 茵陈 柴胡 龙胆 枳实 白鲜皮 茵陈蒿 升麻  角色1 ： 犀角 升麻 玄参 麦门冬 羚羊角 石膏 射干 木通 龙齿 寒水石  角色2 ： 黄连 黄芩 大黄 黄柏 栀子 苦参 龙胆 犀角 白芍 花椒  角色3 ： 黄芩 甘草 黄连 大黄 栀子 郁金 黄柏 半夏 知母 肉桂	烦躁 壮热 谵语 发黄 大便秘结 发狂 丹毒 舌干 舌肿 鼻衄
角色0 ： 木香 槟榔 青皮 使君子 芜荑 雷丸 大黄 芦荟 黄连 鹤虱  角色1 ： 三棱 莪术 青皮 木香 槟榔 巴豆 陈皮 牵牛 干漆 茴香  角色2 ： 豆蔻 肉豆蔻 丁香 白豆蔻 木香 草豆蔻 诃子 胡椒 沉香 高良姜  角色3 ： 丁香 木香 沉香 藿香 檀香 甘松 砂仁 母丁香 青木香 零陵香	腹痛 呕吐 恶心 积滞 疳积 肠鸣 消瘦 里急后重 吞酸 反胃
角色0 ： 荆芥 连翘 牛蒡 牛蒡子 桔梗 防风 薄荷 蝉蜕 紫草 僵蚕  角色1 ： 甘草 桔梗 枳壳 前胡 紫苏叶 陈皮 葛根 防风 桂枝 荆芥  角色2 ： 薄荷 甘草 桔梗 荷叶 荆芥 连翘 黄芩 郁金 防风 天花粉  角色3 ： 连翘 金银花 天花粉 玄参 黄芩 赤芍 薄荷 板蓝根 菊花 蒲公英	咳嗽 头痛 麻疹 鼻塞 恶寒 咽干 丹毒 口渴 恶寒发热 痄腮
角色0 ： 附子 白附子 天麻 僵蚕 天南星 全蝎 蝉蜕 白矾 牛胆 桑螵蛸  角色1 ： 麝香 青黛 牛黄 朱砂 黄连 芦荟 胡黄连 雄黄 熊胆 犀角  角色2 ： 朱砂 麝香 雄黄 巴豆 全蝎 蜈蚣 牛黄 僵蚕 天南星 赭石  角色3 ： 牛黄 朱砂 琥珀 天竺黄 麝香 钩藤 冰片 珍珠 犀角 雄黄	痫 慢惊 神昏 急惊 壮热 口噤 角弓反张 头热 四肢抽搐 弄舌
角色0 ： 柴胡 黄芩 石膏 升麻 甘草 知母 栀子 葛根 葱白 当归  角色1 ： 芍药 赤芍 甘草 黄芩 大黄 葛根 犀角 茵陈 连翘 木通  角色2 ： 甘草 麻黄 石膏 葛根 升麻 桂枝 黄芩 柴胡 寒水石 葱白  角色3 ： 石膏 甘草 麻黄 葛根 黄芩 升麻 葱白 柴胡 麦门冬 寒水石	头痛 壮热 无汗 恶风 恶寒 鼻干 黄汗 项强 口中生疮 胸痛
角色0 ： 当归 川芎 甘草 防风 薏苡仁 茯苓 白鲜皮 土茯苓 牛膝 木瓜  角色1 ： 防风 独活 细辛 秦艽 防己 羌活 麻黄 附子 桂枝 竹沥  角色2 ： 防风 羌活 独活 羚羊角 麻黄 附子 天麻 酸枣仁 薏苡仁 菊花  角色3 ： 牛膝 杜仲 五加 五加皮 续断 木瓜 桑 威灵仙 狗脊 桑寄生	腰痛 口噤 半身不遂 项强 四肢拘急 角弓反张 四肢麻木 舌强 瘫痪 杨梅疮
角色0 ： 远志 石菖蒲 柏子仁 五味子 丹参 酸枣仁 人参 麦冬 琥珀 龙齿  角色1 ： 牡丹 牡丹皮 山药 熟地黄 茯苓 泽泻 山茱萸 五味子 肉桂 当归  角色2 ： 党参 黄芪 鹿角 山药 枸杞子 何首乌 熟地黄 女贞 鹿角胶 菟丝子  角色3 ： 杜仲 菟丝子 牛膝 肉苁蓉 鹿茸 五味子 石斛 山茱萸 续断 巴戟天	头晕 心悸 健忘 腰痛 耳聋 盗汗 小便频数 胸闷 头昏 多梦
角色0 ： 车前 茯苓 车前子 木通 泽泻 赤小豆 冬瓜 枳壳 薏苡仁 车前草  角色1 ： 茯苓 泽泻 白术 猪苓 大腹皮 大豆 茵陈 肉桂 生姜 寒水石  角色2 ： 槟榔 牵牛 防己 郁李 郁李仁 桑 木香 枳壳 牵牛子 木通  角色3 ： 滑石 木通 大黄 瞿麦 冬葵 冬葵子 石韦 枳壳 通草 滑石粉	浮肿 小便不利 小便不通 气喘 腹满 难产 尿血 肥胖 大便秘结 小便黄赤
角色0 ： 龙骨 牡蛎 赤石脂 干姜 当归 禹余粮 紫石英 桑螵蛸 麻黄根 白薇  角色1 ： 黄连 乌梅 甘草 当归 地榆 罂粟 罂粟壳 黄柏 槐花 诃子  角色2 ： 当归 白芍 蒲黄 生地黄 阿胶 芍药 川芎 侧柏叶 藕节 三七  角色3 ： 当归 阿胶 艾叶 芍药 白芍 桑 续断 地榆 桑寄生 卷柏	吐血 便血 脱肛 崩中 漏下 鼻衄 崩漏 里急后重 胎动不安 尿血
角色0 ： 白术 人参 甘草 茯苓 炙甘草 白芍 陈皮 肉桂 桂枝 香附  角色1 ： 甘草 白术 当归 炙甘草 白芍 陈皮 党参 炮姜 人参 升麻  角色2 ： 白术 茯苓 甘草 人参 陈皮 肉桂 白芍 山药 当归 附子  角色3 ： 当归 白芍 芍药 川芎 人参 甘草 桂枝 炮姜 皂荚 鳖甲	自汗 恶寒 身重 恶风 身痛 盗汗 恶寒发热 畏寒 胎动不安 潮热
角色0 ： 川芎 白芷 苍术 防风 羌活 细辛 荆芥 麻黄 藁本 独活  角色1 ： 白芷 防风 川芎 细辛 荆芥 羌活 薄荷 苍耳 苍术 苍耳子  角色2 ： 川乌 乌头 草乌 天麻 地龙 麻黄 五灵脂 何首乌 威灵仙 天南星  角色3 ： 防风 川芎 白芷 羌活 细辛 藁本 蔓荆子 菊花 独活 荆芥	头痛 鼻塞 瘫痪 半身不遂 骨痛 牙痛 无汗 头昏 身痛 皮肤瘙痒
角色0 ： 柴胡 鳖甲 知母 地骨皮 秦艽 青蒿 乌梅 常山 胡黄连 黄连  角色1 ： 甘草 人参 茯苓 麦门冬 柴胡 地骨皮 黄连 瓜蒌 栀子 沙参  角色2 ： 甘草 人参 茯苓 白术 柴胡 当归 枳壳 白芍 前胡 秦艽  角色3 ： 麦门冬 人参 地骨皮 五味子 天门冬 生地黄 茯苓 甘草 芍药 当归	潮热 心烦 盗汗 舌干 口苦 五心烦热 寒热往来 咽干 消瘦 但热不寒
角色0 ： 白矾 巴豆 皂荚 芥子 硫黄 白芥子 白芥 猪牙皂 郁金 雄黄  角色1 ： 白芷 大黄 白及 巴豆 白蔹 五倍子 甘遂 大戟 蓖麻 芫花  角色2 ： 冰片 麝香 雄黄 硼砂 朱砂 轻粉 青黛 樟脑 蟾酥 儿茶  角色3 ： 乳香 没药 血竭 轻粉 麝香 五灵脂 松香 穿山甲 三七 儿茶	瘰疬 臁疮 无名肿毒 牙痛 杨梅疮 口臭 湿疮 胎毒 难产 粉刺
角色0 ： 当归 川芎 白芍 香附 熟地黄 艾叶 杜仲 阿胶 党参 泽兰  角色1 ： 茴香 木香 附子 沉香 肉桂 乌药 小茴香 川楝子 香附 吴茱萸  角色2 ： 桃 桃仁 红花 当归 牛膝 苏木 赤芍 水蛭 虻虫 干漆  角色3 ： 当归 香附 川芎 延胡索 白芍 益母草 红花 丹参 泽兰 蒲黄	腹痛 白带 赤白带 腰痛 崩漏 不孕 腹冷 胞衣不下 恶露不下 难产
角色0 ： 桑 桑白皮 桔梗 五味子 紫菀 桑叶 百合 紫苏叶 款冬花 大腹皮  角色1 ： 杏 杏仁 麻黄 苦杏仁 葶苈子 葱白 紫苏叶 椒目 白前 石膏  角色2 ： 半夏 桔梗 橘红 枇杷 枇杷叶 瓜蒌 川贝母 前胡 紫苏子 枳壳  角色3 ： 杏仁 杏 紫菀 款冬花 百合 五味子 百部 天门冬 麻黄 知母	咳嗽 气喘 咳痰 喉痒 妊娠咳嗽 身痛 哮鸣 顿咳 小儿腹痛 口渴
