甘草 人参 白术 茯苓 当归 白芍 大枣 炙甘草 生姜 芍药	自汗 短气 少气 恶风 恶寒 头重 身重 背痛 消瘦 盗汗
当归 白芍 川芎 阿胶 香附 芍药 艾叶 熟地黄 龙骨 白术	白带 赤白带 崩漏 胎动不安 崩中 漏下 腹痛 不孕 胎漏 闭经
升麻 石膏 黄芩 犀角 甘草 芍药 麦门冬 柴胡 赤芍 栀子	壮热 头痛 烦躁 舌干 口中生疮 头重 呵欠 足热 不寐 善太息
干姜 附子 白术 吴茱萸 人参 厚朴 肉桂 当归 生姜 甘草	腹痛 转筋 腹冷 手足厥冷 面色青 短气 肠鸣 背痛 多唾 畏寒
朱砂 麝香 天麻 牛黄 僵蚕 附子 白附子 全蝎 天南星 雄黄	痫 慢惊 急惊 神昏 口噤 角弓反张 四肢抽搐 弄舌 呵欠 潮热
甘草 麦冬 柴胡 茯苓 薄荷 桔梗 枳壳 黄芩 枇杷 白茅根	咳嗽 吐血 鼻衄 便血 口渴 尿血 胸闷 咳血 舌苔黄 头汗
柴胡 甘草 人参 地骨皮 鳖甲 白芍 知母 芍药 茯苓 当归	心烦 潮热 盗汗 五心烦热 寒热往来 四肢疼痛 消瘦 但热不寒 鼻干 头热
远志 五味子 山药 牛膝 茯苓 菟丝子 杜仲 山茱萸 肉苁蓉 石斛	耳聋 盗汗 腰痛 健忘 目昏 小便频数 遗尿 不寐 少气 腰重
川芎 防风 白芷 细辛 荆芥 羌活 菊花 薄荷 藜 藁本	头痛 目昏 鼻塞 皮肤瘙痒 牙痛 流泪 头昏 偏头痛 喷嚏 拳毛倒睫
当归 芍药 赤芍 桃 桃仁 牡丹 红花 牡丹皮 川芎 蒲黄	腹痛 心烦 胁痛 吐血 难产 四肢疼痛 胞衣不下 恶露不下 寒热往来 胸痛
陈皮 厚朴 香附 砂仁 神曲 苍术 山楂 藿香 青皮 麦芽	呕吐 吞酸 恶心 腹痛 嘈杂 嗳气 反胃 胃痛 腹泻 噎膈
黄芪 党参 山药 何首乌 鹿角 女贞 枸杞子 女贞子 熟地黄 芡实	头晕 心悸 胸闷 健忘 头昏 多梦 食欲不振 畏寒 疲乏 须发早白
木香 丁香 豆蔻 沉香 茴香 肉豆蔻 藿香 肉桂 诃子 白豆蔻	腹痛 呕吐 恶心 肠鸣 吞酸 反胃 里急后重 噎膈 腹冷 积滞
杏 杏仁 桑 紫菀 麻黄 桔梗 桑白皮 款冬花 五味子 橘红	咳嗽 气喘 咳痰 喉痒 妊娠咳嗽 咽干 短气 牙痛 浮肿 阴疮
当归 牛膝 川乌 乌头 防风 白芷 草乌 川芎 羌活 苍术	腰痛 半身不遂 瘫痪 骨痛 四肢麻木 杨梅疮 关节疼痛 臂痛 浮肿 头痛
槟榔 木香 大黄 巴豆 三棱 枳壳 莪术 牵牛 青皮 郁李	浮肿 腹满 腹痛 积滞 疳积 气喘 消瘦 大便秘结 胁痛 寒热往来
防风 麻黄 甘草 羌活 独活 细辛 石膏 桂枝 葛根 羚羊角	头痛 口噤 恶寒 无汗 恶风 项强 角弓反张 四肢拘急 舌强 身痛
黄连 黄芩 大黄 黄柏 栀子 龙胆 胡黄连 芦荟 茵陈 生地黄	烦躁 壮热 里急后重 发黄 便血 大便下血 谵语 口臭 大便秘结 发狂
茯苓 甘草 木通 泽泻 滑石 车前 车前子 猪苓 白术 防己	小便不利 小便不通 浮肿 难产 小便黄赤 身重 烦躁 尿血 大便溏 腹满
甘草 枳壳 半夏 桔梗 前胡 茯苓 陈皮 柴胡 黄芩 旋覆花	头痛 恶寒 咳嗽 壮热 鼻塞 身痛 恶寒发热 无汗 弄舌 头晕
半夏 茯苓 生姜 白术 甘草 人参 陈皮 厚朴 枳实 橘红	呕吐 恶心 干呕 呃逆 腹满 心下痞 小儿呕吐 身重 妊娠呕吐 言语错乱
连翘 薄荷 桔梗 甘草 荆芥 玄参 黄芩 麦冬 牛蒡 竹叶	口渴 麻疹 烦躁 谵语 丹毒 神昏 发狂 大便秘结 咽喉痛 痄腮
甘草 人参 麦门冬 茯苓 麦冬 知母 乌梅 生地黄 枇杷叶 枇杷	咳嗽 吐血 咽干 气喘 干呕 心烦 烦躁 咳血 口臭 寒热往来
乳香 麝香 没药 雄黄 冰片 轻粉 朱砂 白矾 血竭 硼砂	瘰疬 臁疮 无名肿毒 牙痛 杨梅疮 湿疮 口臭 胎毒 粉刺 流泪
乳香 大黄 白芷 木香 没药 川乌 防风 麝香 丁香 芍药	口苦 舌干 脱肛 咽干 胁痛 心烦 耳聋 舌苔白 头痛 难产
