麝香 牛黄 朱砂 黄连 雄黄 天竺黄 琥珀 僵蚕 天麻 犀角	痫 急惊 壮热 慢惊 烦躁 神昏 咳嗽 四肢抽搐 鼻痒 口噤
炙甘草 生姜 甘草 葱白 当归 人参 茯苓 白术 防风 黄芩	吐血 恶寒 鼻衄 头痛 心烦 身痛 鼻干 浮肿 寒热往来 消瘦
杏仁 杏 细辛 麻黄 甘草 附子 防风 人参 干姜 当归	口噤 角弓反张 项强 四肢拘急 神昏 舌强 目昏 短气 半身不遂 背痛
远志 茯苓 当归 人参 五味子 柏子仁 甘草 熟地黄 山药 石菖蒲	健忘 盗汗 心悸 不寐 头晕 心烦 多梦 耳聋 不孕 小便频数
豆蔻 厚朴 生姜 干姜 木香 白术 附子 甘草 人参 吴茱萸	腹痛 呕吐 肠鸣 恶心 转筋 面色青 腹满 腹冷 反胃 消瘦
桑 郁李 郁李仁 桃 桃仁 槟榔 芍药 桑寄生 茯苓 当归	浮肿 小便不利 气喘 腹痛 腰痛 腹满 小便不通 四肢疼痛 心烦 舌苔黄
甘草 干姜 细辛 紫菀 人参 五味子 木香 款冬花 附子 山茱萸	咳嗽 短气 耳聋 干呕 胸痛 难产 头昏 便血 神昏 鼻干
厚朴 陈皮 枳实 神曲 香附 大黄 山楂 砂仁 三棱 青皮	腹痛 吞酸 呕吐 积滞 恶心 嘈杂 嗳气 腹满 噎膈 大便秘结
枇杷 枇杷叶 甘草 茯苓 豆蔻 人参 诃子 白术 白豆蔻 陈皮	呕吐 干呕 小便不通 恶心 难产 反胃 肠鸣 吞酸 口苦 腹冷
防风 羌活 川芎 甘草 白芷 荆芥 薄荷 麻黄 细辛 附子	头痛 鼻塞 牙痛 无汗 恶寒 目昏 慢惊 头昏 恶风 潮热
藜 蒺藜 牡蛎 龙骨 菟丝子 桑 鹿角 茯苓 当归 杜仲	小便频数 遗尿 白带 腰痛 盗汗 皮肤瘙痒 胎动不安 头晕 腹冷 崩漏
桂枝 甘草 生姜 大枣 乌梅 人参 半夏 茯苓 麻黄 芍药	恶寒 无汗 自汗 恶寒发热 短气 少气 腹满 恶风 头痛 身痛
茴香 小茴香 木香 砂仁 甘草 香附 肉桂 当归 白芍 茯苓	腹痛 呕吐 胃痛 嘈杂 恶心 胁痛 食欲不振 吞酸 腰痛 嗳气
藿香 甘草 乌药 木香 丁香 香附 沉香 砂仁 陈皮 茯苓	呕吐 恶心 腹痛 吞酸 手足厥冷 小儿呕吐 肠鸣 胃痛 头晕 头昏
茯苓 山药 熟地黄 泽泻 牡丹 牡丹皮 当归 五味子 山茱萸 枸杞子	目昏 心烦 心悸 头晕 胸闷 盗汗 五心烦热 食欲不振 胸痛 便血
桑 桑白皮 甘草 杏 桑叶 杏仁 马兜铃 连翘 桔梗 知母	咳嗽 气喘 鼻塞 鼻干 瘫痪 小便黄赤 牙痛 身痛 小儿口疮 低热
甘草 犀角 升麻 麦门冬 黄芩 木通 石膏 玄参 连翘 人参	烦躁 壮热 舌干 瘰疬 咽喉痛 头痛 心烦 干呕 丹毒 舌肿
桃 桃仁 当归 红花 川芎 甘草 地榆 赤芍 茯苓 槐花	便血 吐血 杨梅疮 腹痛 脱肛 大便下血 大便秘结 腰痛 不孕 胸闷
竹叶 甘草 连翘 淡竹 薄荷 黄芩 淡竹叶 桔梗 石膏 麦冬	口渴 头痛 咳嗽 烦躁 大便秘结 麻疹 谵语 咽干 恶寒 壮热
茴香 木香 丁香 巴豆 三棱 沉香 豆蔻 莪术 附子 槟榔	腹痛 恶心 呕吐 腹冷 积滞 吞酸 白带 腰痛 小便频数 腹满
当归 延胡索 川芎 香附 蒲黄 赤芍 木香 芍药 白芍 益母草	腹痛 心烦 恶露不下 白带 赤白带 胞衣不下 崩漏 五心烦热 产后腹痛 闭经
牛黄 人参 甘草 龙齿 钩藤 犀角 远志 防风 大黄 石膏	痫 壮热 发狂 心烦 烦躁 言语错乱 脱肛 半身不遂 脐疮 善怒
甘草 芍药 黄芩 赤芍 石膏 柴胡 栀子 大黄 知母 升麻	壮热 头痛 烦躁 心烦 发狂 四肢疼痛 小儿丹毒 妊娠心烦 腰膝无力 耳内流脓
羌活 防风 甘草 柴胡 川芎 荆芥 黄芩 独活 苦参 苍术	头痛 目昏 鼻塞 流泪 皮肤瘙痒 恶风 壮热 麻疹 无汗 恶寒发热
甘草 麦门冬 天门冬 人参 阿胶 黄连 柴胡 知母 桑 黄芩	咳嗽 吐血 心烦 潮热 目昏 气喘 咽干 五心烦热 咳血 烦躁
茯苓 白术 甘草 人参 陈皮 半夏 干姜 山药 砂仁 木香	呕吐 恶心 呃逆 吞酸 反胃 身重 食欲不振 腹泻 疳积 噎膈
甘草 黄连 大黄 白芷 当归 石膏 寒水石 滑石 胡黄连 使君子	疳积 瘰疬 潮热 消瘦 口臭 痫 腹痛 粉刺 牙痛 壮热
当归 羌活 牛膝 防风 芍药 川芎 赤芍 白芷 生地黄 甘草	腰痛 瘫痪 骨痛 半身不遂 浮肿 臂痛 四肢疼痛 烦躁 壮热 背痛
甘草 罂粟 罂粟壳 杏 杏仁 桔梗 桑 陈皮 麦冬 茯苓	咳嗽 气喘 咽干 里急后重 胸闷 腹痛 浮肿 喉痒 咳痰 咳血
吴茱萸 甘草 竹茹 郁金 当归 半夏 茯苓 干姜 人参 陈皮	呕吐 胁痛 呃逆 心烦 噎膈 舌苔白 胸闷 干呕 腹痛 吞酸
菊花 防风 甘草 石膏 蔓荆子 羌活 细辛 川芎 藁本 荆芥	头痛 目昏 鼻塞 偏头痛 头晕 骨痛 项强 头重 恶风 阴挺
麦冬 甘草 知母 当归 黄柏 人参 茯苓 白芍 玄参 山药	吐血 口渴 自汗 盗汗 潮热 咳嗽 咽干 烦躁 咳血 谵语
陈皮 甘草 茯苓 苍术 白术 神曲 厚朴 半夏 山楂 麦芽	腹痛 呕吐 转筋 积滞 恶心 恶寒 头痛 吞酸 嘈杂 腹泻
甘草 人参 芍药 柴胡 黄芩 当归 白术 赤芍 升麻 防风	口噤 恶风 头痛 寒热往来 自汗 心烦 恶寒 咽干 壮热 舌强
皂荚 牵牛 猪牙皂 大黄 羌活 防风 当归 乳香 麻黄 薄荷	瘰疬 吐血 咳嗽 耳聋 难产 无名肿毒 呕吐 半身不遂 四肢麻木 臁疮
桃 鳖甲 木香 桃仁 柴胡 附子 当归 甘草 槟榔 秦艽	舌干 口苦 盗汗 寒热往来 潮热 心烦 目昏 面色青 四肢疼痛 咽干
牛蒡 牛蒡子 连翘 甘草 蝉蜕 防风 荆芥 黄芩 桔梗 僵蚕	麻疹 丹毒 谵语 壮热 烦躁 气喘 胎毒 舌苔白 舌肿 口苦
甘草 人参 麦门冬 茯苓 当归 牡蛎 生地黄 地骨皮 柴胡 酸枣仁	盗汗 心烦 烦躁 潮热 自汗 四肢疼痛 咽干 消瘦 五心烦热 脏躁
当归 川芎 白芍 白术 人参 甘草 芍药 茯苓 熟地黄 阿胶	白带 赤白带 胎动不安 腹痛 崩漏 胎漏 不孕 漏下 面色青 崩中
人参 甘草 当归 茯苓 白术 芍药 白芍 肉桂 益智 麦门冬	自汗 少气 短气 腹痛 畏寒 吐血 遗尿 心悸 口淡 寒战
滑石 甘草 黄芩 木通 车前 大黄 瞿麦 茯苓 车前子 牛黄	小便不通 烦躁 尿血 神昏 谵语 难产 小便不利 肥胖 舌干 发狂
甘草 人参 茯苓 干姜 白术 厚朴 生姜 半夏 附子 当归	呕吐 腹痛 恶寒 头痛 壮热 短气 手足厥冷 身重 肠鸣 身痛
冰片 乳香 麝香 没药 硼砂 雄黄 轻粉 血竭 青黛 朱砂	臁疮 无名肿毒 瘰疬 牙痛 杨梅疮 湿疮 胎毒 流泪 舌肿 胬肉攀睛
泽泻 车前 车前子 茯苓 猪苓 木通 甘草 白术 大腹皮 陈皮	小便不利 浮肿 小便不通 口渴 发黄 小便黄赤 带状疱疹 耳聋 阴痛 盗汗
杏 杏仁 甘草 桔梗 陈皮 薄荷 前胡 半夏 枳壳 紫苏叶	咳嗽 头痛 鼻塞 无汗 恶寒 胸闷 骨痛 口渴 身痛 转筋
女贞 菟丝子 女贞子 何首乌 当归 枸杞子 熟地黄 茯苓 牛膝 山药	头晕 心悸 健忘 头昏 疲乏 腰痛 多梦 须发早白 脱发 畏寒
豆蔻 硫黄 肉豆蔻 木香 附子 丁香 麝香 干姜 赤石脂 龙骨	腹痛 白带 赤白带 脱肛 肠鸣 口臭 里急后重 腰痛 手足厥冷 崩漏
天麻 附子 僵蚕 白附子 半夏 川乌 天南星 防风 全蝎 甘草	头痛 慢惊 痫 半身不遂 目昏 神昏 项强 恶心 鼻塞 瘫痪
杏 杏仁 甘草 茯苓 桑 紫菀 前胡 人参 桔梗 麦门冬	咳嗽 气喘 短气 多唾 妊娠咳嗽 足热 消瘦 皮肤皲裂 妊娠小便不通 善食易饥
附子 茯苓 五味子 人参 石斛 牛膝 泽泻 甘草 磁石 防风	耳聋 少气 腰痛 短气 盗汗 咽干 腹冷 腹满 远视 手足厥冷
牡丹 牡丹皮 当归 甘草 连翘 升麻 防风 柴胡 白芷 陈皮	瘰疬 恶寒 吐血 牙痛 阴疮 舌干 无名肿毒 目昏 少腹痛 产后发热
杏 杏仁 瓜蒌 甘草 半夏 黄芩 桔梗 茯苓 黄连 巴豆	咳嗽 鼻衄 痫 发狂 大便秘结 舌干 身重 口苦 潮热 气喘
芥子 白芥 白芥子 沙参 麦冬 甘草 桑 桔梗 玄参 杏	咳嗽 口渴 咽干 气喘 吐血 头痛 咳痰 声音嘶哑 麻疹 畏寒
当归 龙骨 阿胶 赤石脂 地榆 艾叶 鹿角 干姜 甘草 白术	腹痛 崩中 漏下 吐血 崩漏 白带 赤白带 心烦 月经过多 尿血
牵牛 大黄 甘遂 槟榔 巴豆 木香 附子 芫花 藜 雷丸	浮肿 小便不利 气喘 腹满 积滞 小便不通 腹痛 反胃 短气 疳积
甘草 当归 黄连 黄芩 陈皮 白芍 枳壳 半夏 茯苓 川芎	腹痛 里急后重 呕吐 胁痛 烦躁 口苦 大便秘结 积滞 寒热往来 心下痞
五加 五加皮 牛膝 当归 防风 独活 杜仲 白术 细辛 秦艽	腰痛 四肢麻木 转筋 半身不遂 耳聋 消瘦 关节疼痛 腰膝无力 项强 恶风
枳实 大黄 茵陈 甘草 黄芩 栀子 芍药 当归 柴胡 茯苓	发黄 壮热 腹满 烦躁 头痛 谵语 心下痞 心烦 舌苔黄 黄汗
麝香 乳香 朱砂 巴豆 雄黄 没药 附子 木香 白附子 丁香	慢惊 痫 急惊 瘫痪 神昏 角弓反张 口噤 壮热 潮热 无名肿毒
柴胡 当归 甘草 白芍 红花 白术 香附 黄芩 川芎 茯苓	心烦 胁痛 腹痛 潮热 头晕 口苦 头痛 恶心 头重 五心烦热
