杏 杏仁 桑 紫菀 桔梗 麻黄 桑白皮 款冬花 五味子 百合	咳嗽 气喘 咳痰 胸闷 喉痒 咽干 胁痛 浮肿 妊娠咳嗽 咳血
当归 白芍 川芎 香附 白术 芍药 甘草 阿胶 熟地黄 陈皮	腹痛 白带 赤白带 胎动不安 难产 崩漏 头晕 胁痛 不孕 胎漏
陈皮 厚朴 半夏 苍术 神曲 砂仁 香附 藿香 山楂 麦芽	呕吐 恶心 吞酸 嘈杂 嗳气 胸闷 食欲不振 反胃 腹泻 噎膈
乳香 麝香 没药 雄黄 冰片 轻粉 朱砂 巴豆 白矾 青黛	瘰疬 臁疮 无名肿毒 牙痛 杨梅疮 口臭 湿疮 胎毒 阴疮 粉刺
生姜 干姜 附子 人参 白术 半夏 甘草 厚朴 茯苓 吴茱萸	呕吐 短气 少气 腹痛 腹满 干呕 手足厥冷 背痛 心下痞 转筋
朱砂 麝香 牛黄 僵蚕 附子 天麻 白附子 天南星 全蝎 雄黄	痫 慢惊 神昏 急惊 口噤 壮热 头痛 角弓反张 发狂 四肢抽搐
甘草 枳壳 半夏 桔梗 前胡 茯苓 陈皮 人参 柴胡 麻黄	恶寒 头痛 咳嗽 无汗 身痛 恶寒发热 鼻塞 恶风 项强 舌苔白
柴胡 黄芩 黄连 甘草 黄柏 知母 栀子 大黄 鳖甲 地骨皮	心烦 潮热 口苦 盗汗 烦躁 舌干 五心烦热 寒热往来 咽干 胁痛
当归 黄连 阿胶 甘草 龙骨 乌梅 牡蛎 赤石脂 白芍 地榆	吐血 便血 鼻衄 脱肛 崩漏 崩中 漏下 里急后重 尿血 腹痛
茯苓 木通 泽泻 甘草 滑石 车前 车前子 猪苓 大黄 白术	小便不利 小便不通 浮肿 发黄 难产 小便黄赤 舌苔白 身重 舌苔黄 口渴
当归 芍药 赤芍 桃 桃仁 牡丹 红花 牡丹皮 生地黄 延胡索	腹痛 腰痛 四肢疼痛 胁痛 耳聋 胸痛 吐血 发狂 大便秘结 胞衣不下
甘草 石膏 升麻 黄芩 芍药 犀角 葛根 大黄 赤芍 柴胡	壮热 头痛 烦躁 鼻干 咽喉痛 舌干 口中生疮 舌卷 腹满 舌裂
防风 独活 麻黄 羌活 川乌 乌头 细辛 当归 牛膝 附子	半身不遂 口噤 瘫痪 腰痛 恶风 骨痛 项强 角弓反张 四肢拘急 耳聋
连翘 薄荷 甘草 桔梗 黄芩 荆芥 玄参 牛蒡 天花粉 竹叶	口渴 麻疹 谵语 咳嗽 烦躁 丹毒 头痛 神昏 咽干 发狂
防风 白芷 羌活 川芎 细辛 荆芥 菊花 藜 薄荷 藁本	头痛 鼻塞 目昏 头昏 皮肤瘙痒 流泪 牙痛 偏头痛 无汗 拳毛倒睫
木香 丁香 豆蔻 沉香 附子 茴香 肉豆蔻 干姜 肉桂 吴茱萸	呕吐 腹痛 恶心 肠鸣 腹冷 转筋 吞酸 呃逆 反胃 口臭
人参 甘草 麦门冬 茯苓 麦冬 五味子 远志 知母 天门冬 地骨皮	烦躁 咳嗽 心烦 咽干 口渴 吐血 舌干 口苦 不寐 干呕
杜仲 山药 五味子 牛膝 远志 菟丝子 山茱萸 肉苁蓉 熟地黄 鹿茸	头晕 心悸 健忘 腰痛 耳聋 盗汗 小便频数 多梦 遗尿 不孕
人参 茯苓 白术 甘草 炙甘草 山药 当归 白芍 陈皮 半夏	自汗 盗汗 目昏 短气 身重 消瘦 潮热 恶风 畏寒 头重
槟榔 木香 大黄 青皮 三棱 枳壳 莪术 巴豆 牵牛 黄连	腹痛 浮肿 积滞 腹满 疳积 气喘 里急后重 大便秘结 消瘦 寒热往来
