当归 芍药 赤芍 桃 桃仁 生地黄 牡丹 牡丹皮 红花 蒲黄	吐血 腹痛 鼻衄 便血 胁痛 尿血 咳血 胞衣不下 恶露不下 四肢疼痛
防风 川芎 白芷 细辛 羌活 荆芥 菊花 薄荷 藜 蒺藜	头痛 目昏 鼻塞 皮肤瘙痒 牙痛 流泪 头昏 偏头痛 骨痛 拳毛倒睫
杏 杏仁 桑 紫菀 桔梗 麻黄 桑白皮 五味子 款冬花 百合	咳嗽 气喘 咳痰 喉痒 妊娠咳嗽 粉刺 头昏 胸闷 寒热往来 短气
牛膝 杜仲 五味子 菟丝子 山药 山茱萸 石斛 续断 附子 肉苁蓉	腰痛 耳聋 盗汗 小便频数 遗尿 目昏 头晕 不孕 腰重 腰膝无力
甘草 茯苓 半夏 枳壳 桔梗 陈皮 前胡 人参 橘红 白术	咳嗽 呕吐 头痛 目昏 气喘 鼻塞 胁痛 恶心 多唾 臂痛
人参 生姜 白术 甘草 茯苓 半夏 厚朴 大枣 竹茹 干姜	呕吐 短气 自汗 腹满 干呕 少气 身重 心下痞 背痛 小儿呕吐
黄芩 黄连 大黄 甘草 栀子 黄柏 柴胡 枳实 茵陈 龙胆	烦躁 发黄 大便秘结 心烦 谵语 口苦 胁痛 发狂 舌干 大便下血
麦冬 人参 茯苓 当归 远志 丹参 白芍 山药 白术 五味子	头晕 心悸 健忘 自汗 胸闷 盗汗 多梦 不寐 头昏 心烦
防风 甘草 麻黄 羌活 独活 细辛 桂枝 秦艽 羚羊角 苍术	恶寒 恶风 口噤 无汗 项强 身痛 恶寒发热 头痛 角弓反张 四肢拘急
黄连 麝香 巴豆 雄黄 青黛 朱砂 冰片 白矾 轻粉 胡黄连	壮热 疳积 口臭 痫 牙痛 瘰疬 消瘦 潮热 胎毒 湿疮
甘草 石膏 黄芩 升麻 芍药 麦门冬 葛根 犀角 赤芍 柴胡	壮热 头痛 烦躁 鼻干 心烦 四肢疼痛 干呕 恶寒 舌干 口中生疮
甘草 连翘 桔梗 薄荷 玄参 荆芥 黄芩 牛蒡 天花粉 麦冬	口渴 麻疹 咽干 烦躁 咳嗽 丹毒 谵语 恶寒 发狂 咽喉痛
甘草 人参 柴胡 茯苓 麦门冬 地骨皮 知母 鳖甲 乌梅 芍药	心烦 潮热 盗汗 寒热往来 舌干 口苦 五心烦热 咽干 消瘦 四肢疼痛
陈皮 厚朴 苍术 神曲 砂仁 香附 藿香 山楂 半夏 青皮	呕吐 腹痛 吞酸 恶心 嘈杂 嗳气 噎膈 呃逆 积滞 反胃
木香 丁香 豆蔻 沉香 三棱 槟榔 莪术 肉豆蔻 青皮 茴香	腹痛 呕吐 恶心 肠鸣 积滞 吞酸 里急后重 腹冷 反胃 腹满
茯苓 木通 大黄 泽泻 滑石 槟榔 车前 车前子 牵牛 桑	浮肿 小便不利 小便不通 腹满 气喘 难产 小便黄赤 尿血 产后浮肿 头胀
乳香 没药 川乌 当归 白芷 草乌 乌头 五灵脂 五加 血竭	瘰疬 半身不遂 瘫痪 无名肿毒 臁疮 杨梅疮 骨痛 四肢麻木 难产 阴疮
麝香 朱砂 天麻 附子 僵蚕 牛黄 白附子 全蝎 天南星 雄黄	痫 慢惊 神昏 急惊 口噤 角弓反张 舌强 小儿发热 四肢抽搐 弄舌
干姜 附子 当归 白术 人参 吴茱萸 龙骨 赤石脂 厚朴 甘草	腹痛 崩中 手足厥冷 脱肛 里急后重 腹冷 面色青 转筋 少气 漏下
当归 白芍 川芎 白术 香附 阿胶 芍药 熟地黄 艾叶 肉桂	白带 腹痛 赤白带 崩漏 胎动不安 漏下 胎漏 不孕 难产 闭经
