当归 川芎 白芍 香附 白术 阿胶 熟地黄 益母草 艾叶 肉桂	腹痛 胎动不安 崩漏 不孕 胎漏 漏下 头晕 难产 产后血崩 吐血
甘草 茯苓 人参 白术 半夏 柴胡 芥子 白芥子 白芥 生姜	口苦 舌干 胁痛 咽干 头重 臂痛 足颤 少气 咳痰 言语错乱
附子 天麻 僵蚕 白附子 全蝎 天南星 麝香 朱砂 蜈蚣 雄黄	慢惊 痫 神昏 急惊 口噤 角弓反张 腹满 牙痛 项强 半身不遂
麦冬 甘草 玄参 藜 知母 蒺藜 桔梗 沙参 天冬 丹参	口渴 咽干 咳嗽 心烦 舌干 神昏 消瘦 皮肤瘙痒 耳聋 发狂
麝香 黄连 青黛 白矾 雄黄 胡黄连 冰片 芦荟 使君子 轻粉	牙痛 疳积 口臭 消瘦 胎毒 湿疮 壮热 杨梅疮 阴疮 流泪
乳香 没药 川乌 草乌 五灵脂 血竭 白芷 轻粉 乌头 威灵仙	瘰疬 臁疮 无名肿毒 瘫痪 骨痛 半身不遂 四肢麻木 妊娠心腹胀满 胸闷 恶心
陈皮 厚朴 苍术 藿香 半夏 茯苓 木瓜 白术 砂仁 香薷	呕吐 转筋 胸闷 恶心 腹痛 腹泻 上吐下泻 大便溏 头痛 身重
芍药 赤芍 甘草 柴胡 黄芩 升麻 葛根 石膏 枳实 乌药	头痛 壮热 四肢疼痛 项强 胎毒 舌干 无名肿毒 牙龈肿痛 发癍 瞳神散大
杏 杏仁 麻黄 枇杷 枇杷叶 苦杏仁 紫苏子 川贝母 瓜蒌 葶苈子	咳嗽 气喘 咳痰 喉痒 半身不遂 大便艰难 不孕 小便失禁 骨痛 妊娠呕吐
附子 茴香 肉桂 木香 干姜 硫黄 益智 吴茱萸 益智仁 丁香	腹痛 腹冷 遗尿 面色青 肠鸣 小便频数 畏寒 寒战 头晕 小儿遗尿
朱砂 牛黄 麝香 雄黄 琥珀 冰片 钩藤 天竺黄 珍珠 犀角	痫 神昏 急惊 慢惊 四肢抽搐 弄舌 臂痛 善惊 大便下血 产后发痉
黄芩 黄连 黄柏 大黄 栀子 甘草 知母 柴胡 郁金 升麻	烦躁 谵语 发狂 丹毒 牙痛 舌肿 心下痞 舌卷 大便秘结 小儿丹毒
桑 紫菀 桑白皮 款冬花 五味子 桔梗 百合 百部 桑寄生 桑叶	咳嗽 气喘 妊娠咳嗽 骨痛 短气 咳血 头热 头痛 五心烦热 小便不利
木香 枳壳 槟榔 香附 青皮 陈皮 沉香 乌药 砂仁 姜黄	腹痛 胁痛 呃逆 反胃 噎膈 胃痛 舌苔白 舌苔白腻 潮热 口噤
丁香 豆蔻 木香 肉豆蔻 沉香 白豆蔻 藿香 草豆蔻 高良姜 檀香	呕吐 恶心 肠鸣 吞酸 反胃 腹痛 目昏 面色青 呃逆 头胀
甘草 麻黄 石膏 葛根 桂枝 黄芩 葱白 芍药 苍术 浮萍	头痛 无汗 恶寒 恶风 头汗 四肢疼痛 小便频数 晕厥 瘫痪 小儿木舌
防风 薄荷 荆芥 菊花 羌活 川芎 白芷 荷叶 细辛 石决明	目昏 鼻塞 头痛 流泪 皮肤瘙痒 头昏 喷嚏 拳毛倒睫 胬肉攀睛 远视
大黄 黄芩 栀子 黄连 黄柏 茵陈 龙胆 苦参 枳实 茵陈蒿	壮热 烦躁 大便秘结 发黄 小便黄赤 鼻干 舌苔黄 黄汗 舌苔黄腻 鼻衄
人参 茯苓 甘草 白术 小麦 麻黄根 浮小麦 牡蛎 肉桂 赤小豆	自汗 盗汗 恶风 短气 寒热往来 气喘 浮肿 足热 畏寒 脏躁
白芷 川芎 防风 羌活 细辛 苍术 荆芥 藁本 蔓荆子 天麻	头痛 鼻塞 身痛 偏头痛 恶风 骨痛 噎膈 心下悸 丹毒 痫
甘草 当归 黄连 枳壳 白芍 乌梅 陈皮 木香 地榆 罂粟	腹痛 里急后重 便血 脱肛 大便下血 耳聋 鼻衄 身痛 小儿腹痛 舌疮
当归 芍药 牡丹 赤芍 牡丹皮 白芍 川芎 延胡索 生地黄 熟地黄	心烦 五心烦热 吐血 目昏 四肢疼痛 寒热往来 壮热 谵语 头晕 汗血
当归 桃 桃仁 红花 川芎 赤芍 牛膝 蒲黄 泽兰 肉桂	腹痛 难产 胸痛 恶露不下 胞衣不下 产后腹痛 少腹痛 闭经 烦躁 乳汁不行
生姜 半夏 厚朴 大枣 甘草 枳实 人参 茯苓 竹茹 葱白	腹满 短气 干呕 心下痞 背痛 头昏 转筋 面色青 咽肿 畏寒
升麻 犀角 麦门冬 石膏 羚羊角 甘草 玄参 黄芩 大黄 寒水石	壮热 烦躁 头痛 咽喉痛 咽肿 口中生疮 唇肿 头热 足热 弄舌
桔梗 前胡 枳壳 半夏 橘红 甘草 旋覆花 瓜蒌 法半夏 紫苏叶	咳嗽 目昏 鼻塞 头痛 多唾 背痛 喉痒 寒热往来 恶心 小便不通
神曲 陈皮 山楂 青皮 麦芽 砂仁 香附 枳实 三棱 莪术	吞酸 呕吐 恶心 嘈杂 积滞 嗳气 食欲不振 疳积 腹泻 面色白
山药 党参 熟地黄 黄芪 丹参 何首乌 鹿角 五味子 枸杞子 肉桂	头晕 心悸 健忘 胸闷 食欲不振 多梦 头昏 疲乏 须发早白 畏寒
当归 甘草 生地黄 阿胶 白芍 芍药 麦门冬 蒲黄 黄芩 竹茹	吐血 鼻衄 咳血 便血 尿血 月经过多 白带 崩漏 不射精 头昏
牛膝 杜仲 菟丝子 肉苁蓉 续断 石斛 山茱萸 鹿茸 五加 五加皮	腰痛 耳聋 小便频数 腰重 腰膝无力 四肢麻木 不孕 关节疼痛 腰脊痛 阴痒
甘草 人参 白术 茯苓 炙甘草 陈皮 半夏 炮姜 川芎 当归	恶寒 身重 恶寒发热 头痛 口淡 呵欠 舌苔白 寒战 粉刺 身痛
人参 远志 五味子 麦门冬 茯苓 石菖蒲 酸枣仁 柏子仁 天门冬 磁石	耳聋 健忘 心烦 少气 不寐 短气 多梦 远视 头昏 目昏
巴豆 槟榔 大黄 牵牛 木香 郁李 郁李仁 三棱 甘遂 防己	浮肿 气喘 腹满 积滞 小便不利 产后浮肿 胸闷 目昏 胃痛 牙痛
茯苓 人参 白术 半夏 甘草 陈皮 橘红 绿豆 枳壳 三七	呕吐 恶心 目昏 小儿呕吐 头痛 蟹睛 口渴 胁痛 腰冷 偏头痛
木通 泽泻 滑石 车前 茯苓 车前子 猪苓 瞿麦 大腹皮 冬葵	小便不利 小便不通 浮肿 尿血 带状疱疹 肥胖 头胀 妊娠小便不通 小便清长 小便黄赤
连翘 薄荷 牛蒡 桔梗 荆芥 竹叶 牛蒡子 金银花 天花粉 淡竹	瘰疬 麻疹 杨梅疮 丹毒 口渴 谵语 痄腮 咽喉痛 小儿丹毒 咽肿
柴胡 知母 鳖甲 甘草 地骨皮 人参 秦艽 茯苓 麦门冬 青蒿	潮热 盗汗 寒热往来 消瘦 但热不寒 小儿发热 少气 耳痛 发黄 赤白带
干姜 附子 吴茱萸 白术 细辛 乌头 人参 川乌 大豆 巴豆	腹痛 手足厥冷 短气 少气 转筋 浮肿 多唾 背痛 头昏 舌强
防风 独活 羌活 麻黄 细辛 防己 秦艽 羚羊角 薏苡仁 白鲜皮	口噤 项强 半身不遂 四肢拘急 角弓反张 恶风 舌强 瘫痪 关节疼痛 四肢强直
当归 龙骨 牡蛎 赤石脂 阿胶 白芍 艾叶 干姜 地榆 赭石	白带 赤白带 崩中 漏下 崩漏 腹冷 耳痒 恶露不断 脐湿 腹满
