麝香 芍药 雄黄 琥珀 大黄 没药 丁香 附子 杏 干姜	头痛 耳聋 脱肛 腹痛 胁痛 目昏 阴痒 喷嚏 头昏 咳嗽
芍药 赤芍 甘草 当归 柴胡 黄芩 枳壳 肉桂 丝瓜 大腹皮	口苦 舌干 胁痛 四肢疼痛 寒热往来 烦躁 消瘦 产后发热 耳聋 目昏
人参 茯苓 甘草 白术 半夏 干姜 当归 阿胶 陈皮 黄连	短气 少气 恶风 背痛 自汗 小便不利 头重 多唾 盗汗 消瘦
桔梗 枳壳 前胡 半夏 甘草 陈皮 旋覆花 橘红 茯苓 大腹皮	咳嗽 头痛 鼻塞 气喘 呕吐 舌肿 短气 背痛 妊娠心腹胀满 麻疹
升麻 黄芩 大黄 犀角 栀子 甘草 麦门冬 玄参 射干 羚羊角	烦躁 壮热 谵语 发狂 咽喉痛 舌肿 鼻衄 足热 恶风 心烦
牛黄 朱砂 麝香 雄黄 琥珀 天竺黄 钩藤 冰片 犀角 珍珠	痫 神昏 急惊 慢惊 四肢抽搐 发狂 小儿发热 阴疮 痱子 黄汗
麝香 雄黄 白矾 巴豆 朱砂 冰片 轻粉 青黛 硼砂 皂荚	瘰疬 牙痛 口臭 胎毒 湿疮 小儿口疮 舌疮 阴疮 无名肿毒 鼻痒
白术 人参 茯苓 白芍 当归 肉桂 甘草 炙甘草 山药 党参	自汗 盗汗 消瘦 畏寒 大便溏 心烦 腹痛 头重 带状疱疹 口淡
甘草 薄荷 桔梗 茯苓 麦冬 柴胡 枇杷叶 川贝母 白茅根 枇杷	咳嗽 咽干 胸闷 头痛 口苦 舌苔白 喉痒 咳痰 舌苔白腻 口渴
桑 紫菀 五味子 桑白皮 款冬花 桔梗 天门冬 百合 百部 桑叶	咳嗽 气喘 妊娠咳嗽 潮热 头热 近视 胞衣不下 寒热往来 牙龈溃烂 短气
防风 独活 羌活 麻黄 细辛 附子 羚羊角 秦艽 防己 五加	口噤 项强 恶风 半身不遂 角弓反张 四肢拘急 舌强 四肢强直 足颤 足痛
柴胡 甘草 地骨皮 知母 鳖甲 人参 麦门冬 秦艽 乌梅 青蒿	潮热 盗汗 寒热往来 消瘦 但热不寒 咳嗽 丹毒 小儿口疮 少腹痛 小便黄赤
女贞 女贞子 何首乌 山药 黄精 黄芪 枸杞子 淫羊藿 制何首乌 党参	头晕 心悸 健忘 遗尿 头昏 食欲不振 多梦 疲乏 须发早白 脱发
杏 杏仁 麻黄 苦杏仁 瓜蒌 紫苏子 紫苏叶 葶苈子 橘红 桔梗	咳嗽 气喘 咳痰 四肢拘急 腹满 咽喉痛 舌肿 漏睛 睑弦赤烂 口苦
当归 龙骨 牡蛎 阿胶 赤石脂 艾叶 白芍 芍药 干姜 地榆	白带 赤白带 漏下 崩中 崩漏 干呕 舌光 心烦 小便不通 腰重
丁香 豆蔻 木香 肉豆蔻 沉香 诃子 益智 砂仁 白豆蔻 草豆蔻	呕吐 恶心 肠鸣 吞酸 反胃 腹冷 呃逆 腹泻 阴痛 痫
甘草 人参 麦门冬 茯苓 竹茹 半夏 枇杷 枇杷叶 芦根 小麦	烦躁 吐血 干呕 鼻衄 呃逆 心烦 小便不利 咳嗽 心下悸 咽喉痛
连翘 薄荷 荆芥 桔梗 牛蒡 玄参 牛蒡子 竹叶 天花粉 金银花	口渴 麻疹 丹毒 谵语 咽干 鼻塞 咽肿 烦躁 痄腮 牙龈肿痛
当归 生地黄 黄连 黄柏 黄芩 芍药 白芍 阿胶 蒲黄 地榆	吐血 便血 鼻衄 大便下血 咳血 尿血 发狂 汗血 小便不利 崩中
木通 泽泻 滑石 车前 车前子 茯苓 猪苓 防己 郁李 郁李仁	小便不利 小便不通 浮肿 尿血 妊娠小便不通 头热 产后浮肿 头汗 寒热往来 神昏
甘草 麻黄 桂枝 黄芩 柴胡 苍术 芍药 桔梗 防风 陈皮	恶寒 无汗 身痛 恶寒发热 舌干 麻疹 气喘 项强 漏睛 发癍
威灵仙 红花 草乌 木瓜 樟脑 独活 桂枝 川乌 甘草 肉桂	头痛 骨痛 四肢麻木 腰痛 头昏 臂痛 关节疼痛 瘫痪 舌肿 小便黄赤
陈皮 茯苓 甘草 厚朴 苍术 半夏 藿香 白术 木瓜 砂仁	呕吐 腹痛 转筋 上吐下泻 恶心 面色青 噎膈 胎动不安 腹泻 腹满
干姜 附子 吴茱萸 肉桂 细辛 乌头 硫黄 阳起石 高良姜 大豆	腹痛 腹冷 手足厥冷 面色青 转筋 少气 背痛 自汗 烦躁 多唾
麦冬 远志 丹参 山药 石菖蒲 五味子 玄参 沙参 酸枣仁 天冬	口渴 健忘 胸闷 心悸 咽干 心烦 不寐 发狂 胸痛 肥胖
附子 天麻 僵蚕 白附子 天南星 全蝎 麝香 朱砂 蜈蚣 赭石	慢惊 痫 神昏 急惊 口噤 角弓反张 呵欠 唇肿 痄腮 壮热
甘草 人参 茯苓 白术 当归 麦门冬 五味子 芍药 黄连 前胡	心烦 五心烦热 舌干 头晕 烦躁 头昏 咽干 小便不通 妊娠心烦 少气
槟榔 大黄 木香 三棱 莪术 牵牛 巴豆 青皮 甘遂 枳壳	浮肿 积滞 腹满 大便秘结 疳积 气喘 腹痛 吐血 反胃 腹冷
乳香 没药 川乌 白芷 草乌 乌头 血竭 五灵脂 地龙 白及	瘰疬 臁疮 无名肿毒 瘫痪 半身不遂 杨梅疮 粉刺 痄腮 腹冷 腹中痞块
当归 桃 桃仁 牡丹 红花 牡丹皮 赤芍 延胡索 大黄 牛膝	腹痛 胞衣不下 难产 恶露不下 胸痛 胁痛 产后腹痛 闭经 少腹痛 腰重
当归 川芎 白芍 香附 熟地黄 益母草 阿胶 白术 乌药 泽兰	腹痛 胎动不安 崩漏 难产 不孕 胎漏 面色青 浮肿 寒战 经行腹痛
黄连 大黄 栀子 黄芩 黄柏 龙胆 胡黄连 茵陈 芦荟 使君子	壮热 发黄 烦躁 疳积 大便秘结 口臭 舌苔黄 小便黄赤 舌苔黄腻 舌肿
茯苓 甘草 白术 人参 半夏 陈皮 橘红 吴茱萸 大麦 麻黄	呕吐 恶心 身重 小儿呕吐 腹满 口淡 消瘦 肠鸣 妊娠呕吐 咽干
防风 菊花 藜 羌活 蒺藜 黄芩 荆芥 川芎 苦参 甘草	目昏 杨梅疮 流泪 皮肤瘙痒 拳毛倒睫 胬肉攀睛 鼻干 偏头痛 远视 目干涩
川芎 白芷 细辛 防风 羌活 荆芥 藁本 薄荷 苍术 蔓荆子	头痛 鼻塞 牙痛 头昏 咽肿 难产 小儿鹅口 头重 发黄 小儿腹痛
生姜 半夏 厚朴 甘草 大枣 枳实 茯苓 葱白 陈皮 薤白	呕吐 腹满 短气 心下痞 干呕 恶风 身痛 口苦 恶心 脱肛
木香 槟榔 茴香 枳壳 沉香 香附 乌药 陈皮 青皮 小茴香	腹痛 里急后重 反胃 噎膈 大便秘结 恶心 嘈杂 浮肿 面色青 呃逆
石膏 黄芩 葛根 甘草 知母 升麻 柴胡 栀子 麻黄 寒水石	头痛 壮热 鼻干 小便黄赤 咽干 丹毒 气喘 手足厥冷 小便不利 小便不通
陈皮 神曲 砂仁 香附 山楂 青皮 厚朴 麦芽 枳实 苍术	吞酸 呕吐 嘈杂 嗳气 恶心 胃痛 食欲不振 呃逆 腹泻 积滞
牛膝 杜仲 菟丝子 五味子 山茱萸 石斛 肉苁蓉 续断 山药 熟地黄	腰痛 耳聋 小便频数 盗汗 不孕 少气 腰膝无力 腰重 远视 腰脊痛
