角色0 ： 木香 甘草 白芍 枳壳 槟榔 黄连 当归 罂粟 罂粟壳 陈皮  角色1 ： 泽泻 猪苓 茯苓 白术 甘草 陈皮 苍术 厚朴 滑石 半夏  角色2 ： 车前 木通 车前子 滑石 瞿麦 黄芩 甘草 冬葵 冬葵子 大黄  角色3 ： 藜 蒺藜 防风 附子 羌活 川芎 当归 牛膝 菊花 白芷	小便不通 小便不利 里急后重 腹痛 浮肿 难产 尿血 烦躁 脱肛 腹泻
角色0 ： 龙胆 大黄 茵陈 栀子 黄芩 甘草 柴胡 茵陈蒿 木通 升麻  角色1 ： 甘草 赤芍 当归 柴胡 蒲公英 青皮 郁金 连翘 金银花 丹参  角色2 ： 黄连 麝香 芦荟 青黛 胡黄连 熊胆 牛黄 朱砂 雄黄 使君子  角色3 ： 黄连 胡黄连 柴胡 人参 鳖甲 知母 秦艽 地骨皮 甘草 银柴胡	壮热 烦躁 发黄 潮热 心烦 口苦 盗汗 胁痛 咳嗽 瘰疬
角色0 ： 藁本 白薇 没药 当归 茯苓 白芷 川芎 赤石脂 白术 白芍  角色1 ： 石斛 五味子 附子 人参 木香 茯苓 当归 白术 牛膝 沉香  角色2 ： 木香 诃子 沉香 丁香 豆蔻 檀香 麝香 肉豆蔻 朱砂 荜茇  角色3 ： 益智 益智仁 甘草 茯苓 厚朴 人参 白术 陈皮 石菖蒲 半夏	腹痛 赤白带 遗尿 白带 浮肿 小便频数 腹满 难产 肠鸣 盗汗
角色0 ： 骨碎补 芍药 当归 牛膝 赤芍 细辛 川乌 白芷 何首乌 川芎  角色1 ： 牛膝 杜仲 狗脊 续断 防风 独活 海桐皮 木瓜 附子 木香  角色2 ： 地龙 没药 乳香 乌头 五灵脂 自然铜 草乌 川乌 木鳖子 天麻  角色3 ： 威灵仙 草乌 当归 川乌 麻黄 红花 独活 桂枝 制川乌 五加	瘫痪 腰痛 半身不遂 骨痛 浮肿 臂痛 四肢麻木 口苦 四肢疼痛 偏头痛
角色0 ： 枸杞子 菟丝子 五味子 牛膝 山药 杜仲 茯苓 肉苁蓉 熟地黄 远志  角色1 ： 杏 杏仁 甘草 川芎 当归 阿胶 肉桂 白芍 茯苓 桔梗  角色2 ： 鹿角 鹿角胶 鹿角霜 当归 茯苓 甘草 白术 白芍 人参 川芎  角色3 ： 酸枣仁 远志 柏子仁 人参 石菖蒲 麦门冬 当归 茯苓 五味子 丹参	健忘 目昏 盗汗 吐血 耳聋 不寐 头晕 心烦 痫 烦躁
角色0 ： 地骨皮 白芍 当归 柴胡 知母 牛膝 茯苓 青蒿 甘草 麦冬  角色1 ： 车前 车前子 牡蛎 茯苓 白术 山药 黄柏 龙骨 陈皮 柴胡  角色2 ： 天门冬 生地黄 麦门冬 甘草 紫菀 杏 桔梗 杏仁 知母 桑  角色3 ： 人参 远志 麦门冬 甘草 茯苓 五味子 当归 防风 磁石 泽泻	盗汗 咳嗽 吐血 心烦 潮热 耳聋 舌干 短气 白带 咽干
角色0 ： 连翘 薄荷 桔梗 荆芥 甘草 牛蒡 金银花 牛蒡子 防风 僵蚕  角色1 ： 竹叶 淡竹 淡竹叶 甘草 滑石 人参 麦门冬 柴胡 茯苓 杏仁  角色2 ： 黄芩 栀子 黄连 大黄 黄柏 甘草 枳实 郁金 芒硝 厚朴  角色3 ： 石膏 知母 麦冬 木通 甘草 玄参 连翘 石斛 车前 地骨皮	烦躁 口渴 头痛 咳嗽 麻疹 谵语 心烦 壮热 咽干 发狂
角色0 ： 杏仁 杏 茯苓 甘草 人参 麻黄 柴胡 防己 旋覆花 枳壳  角色1 ： 紫菀 款冬花 五味子 麦门冬 甘草 百部 细辛 人参 干姜 麻黄  角色2 ： 知母 百合 桔梗 甘草 黄芩 麦冬 马兜铃 天冬 茯苓 当归  角色3 ： 桑 桑白皮 五味子 甘草 半夏 阿胶 人参 陈皮 桔梗 麻黄	咳嗽 气喘 短气 浮肿 呕吐 咽干 咳血 鼻塞 心烦 妊娠咳嗽
角色0 ： 知母 黄芩 人参 甘草 柴胡 麦冬 黄连 栀子 乌梅 茯苓  角色1 ： 竹茹 枇杷 枇杷叶 半夏 甘草 人参 茯苓 芦根 生姜 枳壳  角色2 ： 当归 生地黄 黄柏 白芍 陈皮 麦门冬 知母 白术 甘草 川芎  角色3 ： 麦门冬 甘草 石膏 葛根 升麻 犀角 前胡 芍药 玄参 茯苓	烦躁 心烦 头痛 壮热 呕吐 干呕 咳嗽 吐血 舌干 潮热
角色0 ： 大黄 石膏 甘草 滑石 寒水石 牡蛎 黄芩 芍药 人参 龙骨  角色1 ： 牛黄 朱砂 黄连 郁金 冰片 黄芩 雄黄 栀子 珍珠 甘草  角色2 ： 龙齿 牛黄 钩藤 人参 蛇蜕 防风 麝香 朱砂 远志 天竺黄  角色3 ： 犀角 甘草 升麻 麦门冬 黄芩 栀子 大黄 玄参 黄连 龙胆	痫 烦躁 壮热 神昏 心烦 头痛 谵语 发狂 口渴 丹毒
角色0 ： 附子 麝香 天麻 白附子 僵蚕 天南星 牛黄 犀角 麻黄 防风  角色1 ： 前胡 羌活 枳壳 桔梗 甘草 独活 柴胡 川芎 茯苓 人参  角色2 ： 蔓荆子 藁本 升麻 防风 川芎 细辛 羌活 甘草 柴胡 黄芩  角色3 ： 防风 羚羊角 麻黄 细辛 独活 当归 附子 人参 菊花 白术	头痛 口噤 项强 角弓反张 恶风 目昏 舌强 恶寒 鼻塞 四肢拘急
角色0 ： 牛蒡 牛蒡子 甘草 连翘 枳壳 防风 桔梗 大黄 犀角 石膏  角色1 ： 黄连 石榴 石榴皮 当归 白头翁 黄柏 甘草 黄芩 犀角 厚朴  角色2 ： 天花粉 玄参 甘草 桔梗 麦冬 黄芩 金银花 陈皮 薄荷 射干  角色3 ： 荆芥 连翘 防风 木通 赤芍 甘草 升麻 桔梗 紫草 川芎	壮热 麻疹 谵语 口渴 丹毒 烦躁 咳嗽 舌干 腹痛 瘰疬
角色0 ： 杏 杏仁 知母 甘草 川贝母 麦冬 苦杏仁 玄参 桔梗 桑  角色1 ： 夏枯草 菊花 钩藤 黄芩 白芍 桑 牛膝 天麻 地龙 川芎  角色2 ： 女贞 女贞子 白芍 当归 丹参 石斛 珍珠 麦冬 珍珠母 沙参  角色3 ： 木贼 蒺藜 藜 石决明 菊花 蝉蜕 防风 甘草 荆芥 羌活	头晕 流泪 目昏 烦躁 头痛 头昏 心悸 咽干 潮热 心烦
角色0 ： 冰片 牛黄 珍珠 麝香 黄连 琥珀 朱砂 熊胆 硼砂 炉甘石  角色1 ： 雄黄 朱砂 麝香 丁香 蟾酥 冰片 沉香 大戟 木香 大黄  角色2 ： 藿香 甘草 厚朴 香薷 木瓜 茯苓 白芷 广藿香 薄荷 半夏  角色3 ： 乳香 没药 血竭 轻粉 儿茶 冰片 麝香 雄黄 黄柏 大黄	臁疮 无名肿毒 腹痛 转筋 头痛 杨梅疮 呕吐 痫 胸闷 瘰疬
角色0 ： 川芎 细辛 白芷 甘草 防风 石膏 藁本 羌活 荆芥 菊花  角色1 ： 吴茱萸 干姜 茯苓 桔梗 巴豆 人参 皂荚 柴胡 厚朴 黄连  角色2 ： 乌头 川乌 附子 天南星 白附子 草乌 半夏 麻黄 干姜 僵蚕  角色3 ： 藿香 甘松 白芷 麝香 丁香 零陵香 升麻 香附 细辛 沉香	头痛 鼻塞 牙痛 目昏 壮热 口噤 口臭 半身不遂 恶心 白带
角色0 ： 羌活 柴胡 黄芩 牡丹 牡丹皮 麻黄 升麻 栀子 荆芥 大黄  角色1 ： 杏 杏仁 甘草 麻黄 芍药 防风 黄芩 当归 石膏 赤芍  角色2 ： 大黄 桃 桃仁 当归 牛膝 水蛭 虻虫 芍药 牡丹 琥珀  角色3 ： 干姜 细辛 茯苓 防风 大黄 人参 甘草 当归 芍药 白术	壮热 恶寒 恶风 少气 咳嗽 四肢疼痛 腹满 头痛 心烦 短气
角色0 ： 槟榔 芍药 枳壳 木香 大黄 赤芍 当归 桔梗 鳖甲 人参  角色1 ： 甘草 升麻 大黄 玄参 羚羊角 犀角 黄芩 栀子 麦门冬 木通  角色2 ： 郁李 郁李仁 防己 桑 茯苓 槟榔 木通 牵牛 牵牛子 杏  角色3 ： 车前 车前子 防风 决明子 细辛 青葙子 青葙 菊花 黄连 茺蔚子	浮肿 小便不利 目昏 腹满 气喘 小便不通 烦躁 腹痛 心烦 里急后重
角色0 ： 益母草 香附 川芎 白芍 白术 当归 茯苓 砂仁 甘草 黄芩  角色1 ： 延胡索 当归 芍药 赤芍 牡丹 牡丹皮 蒲黄 五灵脂 刘寄奴 肉桂  角色2 ： 三棱 莪术 青皮 枳壳 木香 大黄 香附 槟榔 陈皮 当归  角色3 ： 红花 桃 桃仁 当归 川芎 赤芍 甘草 泽兰 苏木 牛膝	腹痛 赤白带 难产 白带 恶心 口噤 烦躁 恶露不下 潮热 胁痛
角色0 ： 干姜 附子 甘草 人参 白术 茯苓 细辛 五味子 大麦 龙齿  角色1 ： 厚朴 生姜 吴茱萸 白术 枳实 人参 当归 大黄 茯苓 木香  角色2 ： 半夏 柴胡 防风 甘草 茯苓 远志 陈皮 黄芩 羌活 当归  角色3 ： 生姜 大枣 甘草 人参 芍药 当归 麦门冬 半夏 黄芩 茯苓	呕吐 腹痛 短气 少气 腹满 干呕 恶寒 咳嗽 头痛 背痛
角色0 ： 人参 白术 茯苓 甘草 木香 陈皮 砂仁 诃子 前胡 寒水石  角色1 ： 肉桂 附子 白芍 当归 川芎 芍药 香附 丁香 炮姜 艾叶  角色2 ： 干姜 甘草 吴茱萸 当归 芍药 细辛 半夏 赤芍 防风 白芷  角色3 ： 牡丹 牡丹皮 山药 茯苓 泽泻 山茱萸 熟地黄 五味子 麦门冬 当归	腹痛 呕吐 自汗 腹冷 手足厥冷 浮肿 盗汗 短气 小便不利 口噤
角色0 ： 生姜 干姜 豆蔻 草豆蔻 厚朴 白术 高良姜 附子 甘草 诃子  角色1 ： 豆蔻 丁香 肉豆蔻 白豆蔻 木香 人参 白术 甘草 茯苓 沉香  角色2 ： 青皮 槟榔 神曲 木香 三棱 陈皮 砂仁 枳壳 莪术 香附  角色3 ： 半夏 藿香 甘草 陈皮 厚朴 茯苓 白术 草果 苍术 砂仁	呕吐 腹痛 恶心 肠鸣 吞酸 积滞 反胃 转筋 腹冷 嘈杂
角色0 ： 麝香 牛黄 朱砂 雄黄 琥珀 人参 甘草 天竺黄 犀角 珍珠  角色1 ： 半夏 天南星 白矾 生姜 木香 朱砂 郁金 寒水石 人参 滑石  角色2 ： 僵蚕 钩藤 天竺黄 冰片 天麻 全蝎 胆南星 牛黄 朱砂 薄荷  角色3 ： 附子 白附子 天麻 僵蚕 全蝎 麝香 防风 朱砂 青黛 蜈蚣	痫 慢惊 急惊 咳嗽 神昏 头痛 呕吐 烦躁 角弓反张 口噤
角色0 ： 细辛 防风 干姜 乌头 附子 白术 山茱萸 独活 人参 牛膝  角色1 ： 桂枝 生姜 甘草 葱白 芍药 葛根 麻黄 大枣 防风 羌活  角色2 ： 防风 麻黄 防己 甘草 独活 黄芩 白术 人参 附子 秦艽  角色3 ： 苍术 厚朴 陈皮 川芎 白芷 半夏 桔梗 当归 甘草 茯苓	恶寒 头痛 恶风 无汗 口噤 项强 恶寒发热 浮肿 腹痛 身痛
角色0 ： 丹参 红花 桃 赤芍 桃仁 川芎 当归 黄芪 地龙 鸡血藤  角色1 ： 桑 桑枝 当归 秦艽 牛膝 独活 木瓜 五加皮 五加 红花  角色2 ： 川乌 三棱 当归 芫花 大黄 巴豆 五倍子 肉桂 草乌 白芷  角色3 ： 红花 蜈蚣 全蝎 乳香 苏木 没药 黄芩 僵蚕 穿山甲 紫草	鼻衄 无名肿毒 瘰疬 半身不遂 四肢麻木 胸闷 难产 咽干 背痛 头痛
角色0 ： 当归 白芍 芍药 熟地黄 黄芩 川芎 防风 羌活 白术 生地黄  角色1 ： 薄荷 川芎 防风 细辛 荆芥 甘草 荷叶 白芷 羌活 石膏  角色2 ： 僵蚕 天麻 荆芥 蝉蜕 甘草 陈皮 石菖蒲 独活 附子 半夏  角色3 ： 川乌 细辛 草乌 川芎 麻黄 苍术 防风 白芷 当归 荆芥	头痛 鼻塞 目昏 半身不遂 耳聋 头昏 牙痛 瘫痪 咳嗽 痫
角色0 ： 芥子 白芥 白芥子 甘草 柴胡 当归 茯苓 白术 麦冬 白芍  角色1 ： 羌活 藿香 半夏 苍术 防风 厚朴 川芎 陈皮 前胡 枳壳  角色2 ： 丹参 郁金 泽泻 川芎 山楂 白术 黄芪 人参 牛膝 沉香  角色3 ： 细辛 丁香 藿香 木香 薄荷 降香 陈皮 砂仁 香附 桂枝	胸闷 头痛 恶心 咳嗽 呕吐 腹痛 恶寒 腹满 肥胖 发狂
角色0 ： 巴豆 朱砂 麝香 轻粉 雄黄 巴豆霜 牛黄 全蝎 青黛 天南星  角色1 ： 杏 杏仁 巴豆 蓖麻 乳香 甘遂 百草霜 蓖麻子 半夏 蜂房  角色2 ： 木香 升麻 沉香 大黄 甘草 连翘 犀角 麝香 丁香 玄参  角色3 ： 斑蝥 五灵脂 丁香 三棱 麝香 巴豆 莪术 赤芍 雄黄 蜈蚣	瘰疬 痫 急惊 耳聋 腹痛 臁疮 壮热 小便不通 咳嗽 疳积
角色0 ： 龙骨 牡蛎 桑 桑螵蛸 芡实 茯苓 山药 莲须 白芍 菟丝子  角色1 ： 枸杞子 熟地黄 淫羊藿 山药 菟丝子 黄芪 覆盆子 茯苓 当归 甘草  角色2 ： 石斛 远志 肉苁蓉 五味子 茯苓 菟丝子 山茱萸 蛇床子 人参 泽泻  角色3 ： 杜仲 鹿茸 牛膝 续断 附子 菟丝子 肉苁蓉 人参 当归 补骨脂	腰痛 头晕 盗汗 耳聋 健忘 小便频数 遗尿 白带 自汗 短气
角色0 ： 甘遂 芫花 大戟 当归 大黄 泽泻 商陆 雄黄 吴茱萸 乳香  角色1 ： 使君子 黄连 槟榔 芜荑 雷丸 胡黄连 芦荟 神曲 青皮 陈皮  角色2 ： 牵牛 牵牛子 大黄 槟榔 木香 枳壳 甘草 黄芩 枳实 香附  角色3 ： 巴豆 三棱 木香 青皮 莪术 陈皮 丁香 干漆 干姜 五灵脂	腹痛 疳积 积滞 浮肿 消瘦 呕吐 大便秘结 小便不通 腹满 潮热
角色0 ： 硫黄 附子 吴茱萸 木香 桃 当归 桃仁 干姜 槟榔 阿魏  角色1 ： 蛇床子 菟丝子 丁香 牛膝 远志 麝香 甘草 鹿茸 母丁香 附子  角色2 ： 胡椒 肉豆蔻 豆蔻 附子 丁香 人参 干姜 荜茇 木香 白术  角色3 ： 茴香 附子 肉苁蓉 沉香 木香 补骨脂 川楝子 葫芦 牛膝 巴戟天	腹痛 面色青 腰痛 肠鸣 手足厥冷 赤白带 白带 呕吐 恶心 转筋
角色0 ： 阿胶 当归 芍药 艾叶 甘草 川芎 人参 白芍 干姜 白术  角色1 ： 地榆 黄连 当归 黄芩 枳壳 槐花 白芍 黄柏 槐角 荆芥  角色2 ： 蒲黄 甘草 黄芩 侧柏叶 白芍 小蓟 生地黄 藕节 茜草 荷叶  角色3 ： 桑 桑白皮 甘草 茯苓 地骨皮 桔梗 人参 白术 知母 柴胡	吐血 便血 腹痛 鼻衄 大便下血 尿血 崩漏 咳嗽 胎动不安 漏下
角色0 ： 大腹皮 木通 木香 槟榔 陈皮 桑 甘草 茯苓 木瓜 青皮  角色1 ： 黄柏 牛膝 当归 杜仲 知母 山药 人参 五味子 天冬 茯苓  角色2 ： 五加 五加皮 牛膝 防风 薏苡仁 丹参 独活 芍药 地骨皮 石斛  角色3 ： 川芎 苍术 杜仲 桃 白芍 砂仁 白术 当归 茴香 陈皮	浮肿 腰痛 口苦 盗汗 消瘦 目昏 赤白带 白带 食欲不振 舌干
角色0 ： 香附 陈皮 苍术 厚朴 砂仁 甘草 枳壳 木香 藿香 附子  角色1 ： 川芎 当归 白芍 芍药 人参 甘草 熟地黄 白术 海金沙 茯苓  角色2 ： 半夏 茯苓 陈皮 白术 甘草 黄连 神曲 栀子 枳实 合欢皮  角色3 ： 柴胡 白芍 黄芩 甘草 当归 青皮 白术 薄荷 钩藤 郁金	腹痛 呕吐 胁痛 恶心 头痛 寒热往来 嘈杂 口苦 吞酸 咳嗽
角色0 ： 升麻 黄柏 柴胡 甘草 羌活 当归 人参 防风 炙甘草 豆蔻  角色1 ： 橘红 甘草 半夏 茯苓 枳壳 石菖蒲 人参 白术 厚朴 木香  角色2 ： 茯苓 当归 金银花 防风 土茯苓 川芎 甘草 白鲜皮 木通 木瓜  角色3 ： 泽泻 苍术 白术 猪苓 茯苓 陈皮 黄连 茵陈 神曲 青皮	杨梅疮 身重 发黄 小便不利 心下痞 恶寒 呕吐 恶风 小便黄赤 阴疮
角色0 ： 鳖甲 甘草 柴胡 常山 乌梅 青蒿 大黄 知母 犀角 麝香  角色1 ： 当归 白芍 木香 红花 厚朴 甘草 香附 青皮 木通 川楝子  角色2 ： 附子 巴豆 藜芦 干姜 藜 雄黄 细辛 人参 大黄 麝香  角色3 ： 桃 桃仁 当归 甘草 茯苓 人参 槟榔 白术 芍药 大黄	腹满 腹痛 壮热 潮热 咳嗽 口噤 消瘦 大便秘结 烦躁 盗汗
角色0 ： 女贞 女贞子 桑 何首乌 黄芪 桑椹 熟地黄 菟丝子 枸杞子 制何首乌  角色1 ： 茴香 小茴香 香附 川芎 当归 艾叶 延胡索 木香 白芍 吴茱萸  角色2 ： 羌活 乳香 木瓜 没药 桂枝 独活 马钱 牛膝 马钱子 杜仲  角色3 ： 杜仲 当归 白术 茯苓 山药 续断 补骨脂 川芎 人参 泽泻	腰痛 头晕 心悸 白带 头昏 疲乏 脱发 四肢麻木 腹痛 须发早白
角色0 ： 藿香 广藿香 厚朴 半夏 车前 陈皮 青蒿 黄芩 滑石 大黄  角色1 ： 山药 茯苓 白术 白扁豆 甘草 党参 人参 芡实 莲子 陈皮  角色2 ： 黄连 半夏 枳实 茯苓 黄芩 白术 香附 瓜蒌 法半夏 甘草  角色3 ： 山楂 麦芽 神曲 陈皮 厚朴 苍术 甘草 砂仁 枳壳 莱菔子	呕吐 吞酸 腹痛 食欲不振 恶心 腹泻 嘈杂 嗳气 积滞 恶寒
角色0 ： 羌活 牛膝 当归 防风 独活 木瓜 白芍 秦艽 川芎 杜仲  角色1 ： 白术 人参 茯苓 甘草 紫苏子 地榆 天葵 薄荷 炮姜 半夏  角色2 ： 木香 柴胡 鳖甲 槟榔 沉香 附子 枳壳 茯苓 人参 当归  角色3 ： 白芷 川芎 乌药 陈皮 甘草 桔梗 香附 枳壳 半夏 当归	头痛 咳嗽 舌干 身痛 转筋 目昏 半身不遂 腹痛 寒热往来 四肢疼痛
角色0 ： 桔梗 枳壳 半夏 甘草 陈皮 茯苓 木香 葛根 紫苏叶 瓜蒌  角色1 ： 前胡 半夏 茯苓 甘草 旋覆花 槟榔 大腹皮 枳实 细辛 生姜  角色2 ： 黄芩 芍药 柴胡 大黄 赤芍 当归 甘草 木通 栀子 黄连  角色3 ： 人参 白术 茯苓 甘草 麦门冬 五味子 黄芩 蓼蓝 瓜蒌 枳壳	咳嗽 呕吐 头痛 壮热 寒热往来 气喘 口苦 目昏 小便不利 烦躁
角色0 ： 麝香 朱砂 乳香 附子 僵蚕 全蝎 牛黄 白附子 天麻 赭石  角色1 ： 天麻 全蝎 防风 人参 川芎 羌活 茯苓 僵蚕 甘草 独活  角色2 ： 麻黄 甘草 白术 麻黄根 当归 人参 牡蛎 小麦 茯苓 浮小麦  角色3 ： 木通 泽泻 薄荷 陈皮 槟榔 苍术 柴胡 防风 羌活 枳壳	慢惊 盗汗 痫 自汗 神昏 头痛 浮肿 腹痛 潮热 恶寒
角色0 ： 木香 枳壳 香附 姜黄 厚朴 沉香 郁金 砂仁 青皮 柴胡  角色1 ： 乳香 没药 当归 甘草 白芷 赤芍 芍药 川芎 陈皮 附子  角色2 ： 羌活 防风 乌药 牛膝 木香 麝香 僵蚕 苍术 青皮 沉香  角色3 ： 连翘 海藻 昆布 防风 夏枯草 金银花 甘草 穿山甲 皂角刺 桔梗	瘰疬 恶心 嘈杂 嗳气 舌苔白 无名肿毒 胃痛 呕吐 吞酸 呃逆
角色0 ： 前胡 桔梗 杏仁 杏 枳壳 甘草 陈皮 桑 半夏 荆芥  角色1 ： 橘红 桑 紫苏子 桑白皮 桔梗 枇杷叶 枇杷 川贝母 半夏 百部  角色2 ： 苦杏仁 黄芩 紫苏叶 杏 杏仁 陈皮 浙贝母 薄荷 天花粉 甘草  角色3 ： 麻黄 杏仁 杏 甘草 石膏 半夏 五味子 生姜 细辛 桂枝	咳嗽 气喘 恶寒 鼻塞 头痛 咽干 无汗 胸闷 口渴 恶寒发热
角色0 ： 白芷 桑 苍术 川芎 苍耳 苦参 防风 桑白皮 苍耳子 麻黄  角色1 ： 连翘 菊花 桑叶 桑 金银花 薄荷 甘草 蝉蜕 板蓝根 野菊花  角色2 ： 薄荷 青黛 硼砂 甘草 冰片 荷叶 乌梅 玄明粉 石膏 诃子  角色3 ： 杏 杏仁 赭石 茯苓 旋覆花 半夏 瓜蒌 郁金 橘红 冬瓜	咳嗽 头痛 鼻塞 咽干 丹毒 口渴 鼻衄 呃逆 噎膈 瘫痪
角色0 ： 乳香 麝香 朱砂 没药 雄黄 血竭 白矾 蟾酥 轻粉 丁香  角色1 ： 赤石脂 黄连 龙骨 干姜 豆蔻 肉豆蔻 当归 厚朴 生姜 木香  角色2 ： 龙骨 赤石脂 当归 禹余粮 牡蛎 艾叶 附子 鹿茸 干姜 白芷  角色3 ： 樟脑 冰片 丁香 白芷 肉桂 薄荷 川乌 当归 麝香 独活	腹痛 白带 赤白带 崩中 脱肛 肠鸣 漏下 骨痛 里急后重 便血
角色0 ： 石膏 黄芩 升麻 甘草 葛根 麻黄 栀子 柴胡 知母 大黄  角色1 ： 芍药 赤芍 甘草 当归 麻黄 白术 荆芥 前胡 五味子 厚朴  角色2 ： 柴胡 地骨皮 麦门冬 人参 茯苓 桑 鳖甲 秦艽 知母 甘草  角色3 ： 防风 羚羊角 枳壳 甘草 羌活 茯苓 菊花 独活 人参 旋覆花	壮热 头痛 心烦 潮热 烦躁 目昏 四肢疼痛 盗汗 咽干 无汗
角色0 ： 麦冬 远志 五味子 丹参 茯苓 当归 玄参 天冬 甘草 石菖蒲  角色1 ： 炙甘草 甘草 党参 黄芪 白术 茯苓 肉桂 龙眼 熟地黄 木香  角色2 ： 人参 陈皮 白术 甘草 当归 柴胡 升麻 茯苓 乌梅 苍术  角色3 ： 白芍 当归 川芎 茯苓 白术 山药 香附 砂仁 阿胶 甘草	自汗 心悸 咳嗽 口渴 健忘 头晕 盗汗 心烦 腹痛 脱肛
角色0 ： 丁香 木香 沉香 豆蔻 槟榔 麝香 檀香 附子 肉豆蔻 藿香  角色1 ： 乌药 肉桂 当归 附子 薄荷 木香 赤芍 红花 半夏 大黄  角色2 ： 莪术 甘草 三棱 香附 益智 砂仁 青皮 甘松 益智仁 木香  角色3 ： 茴香 干姜 甘草 陈皮 肉桂 胡椒 丁香 小茴香 厚朴 砂仁	呕吐 恶心 腹痛 吞酸 呃逆 腹满 肠鸣 干呕 口苦 口臭
角色0 ： 芍药 白芍 人参 当归 甘草 茯苓 五味子 麦门冬 白术 熟地黄  角色1 ： 续断 杜仲 川芎 阿胶 白术 当归 艾叶 白芍 香附 甘草  角色2 ： 柏子仁 泽兰 干姜 当归 细辛 防风 人参 厚朴 白芷 芜荑  角色3 ： 桑 桑寄生 当归 甘草 人参 独活 茯苓 狗脊 秦艽 防风	腹痛 胎动不安 腰痛 白带 赤白带 漏下 少气 崩中 咳嗽 胎漏
角色0 ： 沙参 麦冬 北沙参 桑 桑叶 梨 天冬 百部 玉竹 南沙参  角色1 ： 连翘 赤芍 草乌 川乌 蜈蚣 大黄 独活 白芷 红花 当归  角色2 ： 玄参 薄荷 桔梗 荆芥 牛蒡 大青叶 柴胡 牛蒡子 黄芩 葛根  角色3 ： 白及 白芷 当归 白蔹 木鳖子 乳香 没药 黄柏 黄连 大黄	咳嗽 吐血 瘰疬 臁疮 口渴 鼻衄 咽干 无名肿毒 头痛 谵语
角色0 ： 连翘 黄芩 薄荷 桔梗 黄连 大黄 栀子 赤芍 当归 甘草  角色1 ： 防风 荆芥 白芷 羌活 川芎 甘草 黄芩 苍术 麻黄 柴胡  角色2 ： 苦参 玄参 防风 丹参 藜 苍耳 人参 蒺藜 甘草 沙参  角色3 ： 生地黄 芍药 当归 牡丹 牡丹皮 赤芍 升麻 甘草 黄连 白芍	头痛 大便秘结 皮肤瘙痒 恶寒 无汗 吐血 麻疹 烦躁 鼻衄 牙痛
