角色0 ： 白芍 当归 川芎 熟地黄 延胡索 生地黄 甘草 芍药 蒺藜 白矾  角色1 ： 阿胶 当归 艾叶 香附 续断 半夏 甘草 牛膝 蝉蜕 知母  角色2 ： 白芍 当归 川芎 香附 白术 益母草 柴胡 菊花 山药 木香  角色3 ： 当归 阿胶 川芎 香附 党参 大豆 人参 丹参 绿豆 沉香	吐血 胎动不安 崩漏 便血 胎漏 鼻衄 漏下 尿血 腹冷 骨痛
角色0 ： 茯苓 白术 人参 陈皮 白矾 赤小豆 甘遂 赤石脂 羚羊角 香附  角色1 ： 泽泻 茯苓 猪苓 白术 蒲公英 柴胡 丁香 桂枝 陈皮 僵蚕  角色2 ： 甘草 茯苓 枳壳 陈皮 白芍 苦参 泽泻 铅丹 人参 硫黄  角色3 ： 白术 陈皮 苍术 茯苓 甘草 柴胡 猪苓 茵陈 当归 远志	小便不利 浮肿 身重 大便溏 臂痛 目昏 头重 鼻塞 吞酸 咳痰
角色0 ： 麻黄 桂枝 甘草 芍药 杏仁 丹参 天门冬 前胡 猪牙皂 川芎  角色1 ： 甘草 葛根 防风 葱白 黄芩 桂枝 生姜 柴胡 芍药 白薇  角色2 ： 麻黄 石膏 甘草 葛根 生姜 细辛 桔梗 半夏 花椒 青黛  角色3 ： 甘草 芍药 麻黄 葛根 枳壳 大黄 郁金 赤芍 苍术 附子	无汗 恶风 头痛 恶寒 大便溏 舌肿 畏寒 神昏 反胃 皮肤瘙痒
角色0 ： 黄连 青黛 龙胆 芜荑 胡黄连 甘草 使君子 青皮 藁本 苦参  角色1 ： 麝香 青黛 熊胆 芦荟 胡黄连 黄连 龙胆 蟾酥 瓜蒂 蜗牛  角色2 ： 黄连 大黄 黄柏 胡黄连 白矾 陈皮 赤小豆 铅丹 雷丸 黄芩  角色3 ： 使君子 黄连 胡黄连 芜荑 芦荟 雷丸 鹤虱 夜明砂 三棱 轻粉	疳积 壮热 消瘦 口臭 潮热 鼻干 腹痛 鼻痒 心烦 头热
角色0 ： 木香 沉香 青木香 丁香 香附 槟榔 栀子 三棱 党参 冰片  角色1 ： 巴豆 木香 丁香 巴豆霜 硫黄 胡椒 枳壳 五灵脂 朱砂 青皮  角色2 ： 丁香 木香 沉香 茴香 母丁香 藿香 高良姜 当归 地龙 檀香  角色3 ： 木香 槟榔 沉香 乌药 青皮 附子 木瓜 泽泻 高良姜 人参	腹痛 里急后重 壮热 胸闷 痫 耳聋 腹泻 声音嘶哑 大便溏 半身不遂
角色0 ： 郁李 防己 郁李仁 桑 槟榔 木通 木香 泽漆 蛇蜕 大黄  角色1 ： 槟榔 枳壳 木香 大腹皮 青皮 桑 牵牛 肉桂 大黄 防风  角色2 ： 牵牛 牵牛子 甘遂 芫花 大戟 槟榔 商陆 鳖甲 巴豆 五倍子  角色3 ： 槟榔 大黄 木香 大腹皮 枳壳 百合 附子 赤芍 防风 椒目	浮肿 气喘 小便不利 烦躁 背痛 干呕 牙龈肿痛 寒热往来 胸痛 尿血
角色0 ： 钩藤 麝香 牛黄 龙齿 朱砂 蛇蜕 犀角 天竺黄 蜂房 蟾酥  角色1 ： 麝香 朱砂 牛黄 雄黄 蟾酥 冰片 天竺黄 郁金 木通 牡蛎  角色2 ： 琥珀 珍珠 牛黄 冰片 天竺黄 朱砂 水牛角 安息香 珍珠母 胆南星  角色3 ： 朱砂 雄黄 麝香 牛黄 冰片 蟾酥 黄连 白矾 甘草 红参	痫 神昏 牙痛 急惊 咳血 四肢疼痛 杨梅疮 关节疼痛 谵语 腰重
角色0 ： 桑 桑白皮 桑寄生 桑叶 橘红 白芷 阿胶 酸枣仁 龙胆 乌梅  角色1 ： 杏仁 杏 麻黄 白矾 升麻 紫苏子 藿香 白术 红粉 阿胶  角色2 ： 杏 杏仁 麻黄 人参 鸡子 熊胆 天门冬 龙眼 延胡索 辛夷  角色3 ： 桑 桑白皮 地骨皮 桔梗 马兜铃 虎杖 瓜蒌 人参 桂皮 楮实子	咳嗽 气喘 舌苔白 咽肿 嗳气 喉痒 腹泻 慢惊 寒战 腹满
角色0 ： 当归 人参 白术 白芍 橘红 柴胡 阿胶 芍药 麻黄 石斛  角色1 ： 白术 甘草 人参 茯苓 陈皮 炙甘草 附子 沉香 远志 蔓荆子  角色2 ： 甘草 茯苓 人参 麦门冬 芍药 五味子 枳实 黄连 木通 藁本  角色3 ： 白术 人参 干姜 茯苓 远志 白芍 大枣 天麻 枸杞子 白鲜皮	自汗 盗汗 干呕 拳毛倒睫 头汗 头晕 麻疹 烦躁 五心烦热 恶心
角色0 ： 砂仁 香附 青皮 陈皮 枳实 五灵脂 橘红 乌梅 黄芩 谷芽  角色1 ： 神曲 山楂 麦芽 莱菔子 鸡内金 谷芽 橘红 片姜黄 姜黄 猪苓  角色2 ： 神曲 山楂 麦芽 砂仁 枳实 陈皮 厚朴 法半夏 甘草 海螵蛸  角色3 ： 厚朴 砂仁 苍术 香附 陈皮 枳实 神曲 姜黄 白芍 乌药	吞酸 嘈杂 嗳气 食欲不振 积滞 胃痛 呕吐 腹泻 胸闷 小儿厌食
角色0 ： 豆蔻 肉豆蔻 草豆蔻 高良姜 白豆蔻 砂仁 硫黄 紫苏叶 车前草 荜茇  角色1 ： 丁香 木香 沉香 胡椒 荜澄茄 荜茇 高良姜 茴香 萝卜 陈皮  角色2 ： 豆蔻 肉豆蔻 白豆蔻 诃子 丁香 木香 草豆蔻 茯苓 夜明砂 射干  角色3 ： 丁香 藿香 甘松 檀香 沉香 砂仁 零陵香 肉桂 姜黄 前胡	呕吐 肠鸣 恶心 吞酸 脱肛 反胃 面色青 呃逆 瘰疬 心下痞
角色0 ： 当归 甘草 陈皮 肉桂 竹茹 炙甘草 附子 柴胡 茯苓 生地黄  角色1 ： 茯苓 人参 白术 甘草 柴胡 泽泻 五味子 麦门冬 地骨皮 桑螵蛸  角色2 ： 人参 白术 茯苓 甘草 当归 香附 瓜蒌 天门冬 红花 附子  角色3 ： 甘草 白芍 白术 当归 侧柏叶 半夏 茯苓 龙胆 羌活 安息香	心烦 五心烦热 咽干 头晕 目干涩 唇肿 善怒 耳痛 面色青 喉痒
角色0 ： 人参 白术 炙甘草 茯苓 甘草 干姜 半夏 黄连 茴香 蕤仁  角色1 ： 甘草 茯苓 当归 半夏 苍术 炙甘草 桔梗 羌活 苦参 肉桂  角色2 ： 人参 茯苓 白术 苦参 陈皮 桂枝 桑 姜黄 麻黄 藿香  角色3 ： 甘草 芍药 白术 当归 附子 茯苓 白矾 玄参 赤芍 蛇床子	自汗 短气 盗汗 目昏 恶风 背痛 腹痛 舌苔白 消瘦 口噤
角色0 ： 菊花 苦参 防风 细辛 苍耳 羌活 苍耳子 白鲜皮 野菊花 辛夷  角色1 ： 防风 羌活 荆芥 羚羊角 菊花 生姜 石决明 旋覆花 丁香 牡蛎  角色2 ： 菊花 防风 羚羊角 蔓荆子 羌活 细辛 旋覆花 蝉蜕 石膏 升麻  角色3 ： 藜 蒺藜 石决明 木贼 藜芦 决明子 青葙 青葙子 茺蔚子 谷精草	目昏 流泪 皮肤瘙痒 远视 胬肉攀睛 近视 独语 胎毒 腹满 小儿发热
角色0 ： 甘草 川芎 白术 枳壳 枳实 麻黄 麝香 桔梗 玄明粉 白芷  角色1 ： 当归 白芍 芍药 茯苓 人参 山药 竹沥 青皮 滑石 赤芍  角色2 ： 当归 芍药 柴胡 甘草 川芎 白芍 葛根 细辛 陈皮 赤小豆  角色3 ： 柴胡 黄芩 陈皮 甘草 茯苓 青皮 半夏 珍珠 升麻 雷丸	胁痛 耳聋 寒热往来 口苦 恶寒 少气 短气 鼻塞 大便秘结 胎毒
角色0 ： 栀子 大黄 黄芩 甘草 黄连 人参 石膏 乌梅 荆芥 皂角刺  角色1 ： 甘草 升麻 黄芩 大黄 芍药 柴胡 白鲜皮 王不留行 党参 麻黄  角色2 ： 甘草 黄芩 柴胡 赤芍 苦参 前胡 熟地黄 木通 黄连 天麻  角色3 ： 大黄 芍药 黄芩 黄连 蜂房 黄柏 当归 大枣 知母 郁金	烦躁 谵语 壮热 发狂 口渴 气喘 呕吐 麻疹 头昏 大便溏
角色0 ： 附子 干姜 人参 白术 肉桂 吴茱萸 硫黄 牡蛎 阿胶 芍药  角色1 ： 肉桂 芥子 白芥 白芥子 当归 茯苓 槟榔 白芍 郁金 干姜  角色2 ： 附子 干姜 硫黄 吴茱萸 白矾 阳起石 茴香 防风 琥珀 雄黄  角色3 ： 干姜 附子 肉桂 吴茱萸 乌梅 贯众 硼砂 冬瓜皮 秦艽 鬼箭羽	腹冷 手足厥冷 转筋 畏寒 心烦 肠鸣 头重 痫 湿疮 反胃
角色0 ： 乳香 没药 蓖麻 蓖麻子 松香 轻粉 穿山甲 樟脑 木鳖子 藿香  角色1 ： 乳香 没药 血竭 轻粉 儿茶 冰片 象皮 阿魏 穿山甲 松香  角色2 ： 茴香 小茴香 川楝子 阿魏 穿山甲 大黄 胡芦巴 巴豆 葫芦 轻粉  角色3 ： 轻粉 冰片 硼砂 麝香 儿茶 雄黄 炉甘石 海螵蛸 胆矾 人参	无名肿毒 臁疮 瘰疬 牙痛 湿疮 杨梅疮 胎毒 少腹痛 气喘 咳嗽
角色0 ： 茯苓 陈皮 白术 人参 槟榔 山药 石膏 郁金 赭石 麦门冬  角色1 ： 茯苓 赭石 甘草 代赭石 白术 旋覆花 人参 生姜 麦门冬 胡椒  角色2 ： 人参 茯苓 白术 半夏 当归 竹茹 柴胡 黄连 滑石 小茴香  角色3 ： 白术 甘草 人参 陈皮 桔梗 生姜 乌药 硼砂 党参 百草霜	呕吐 呃逆 小儿呕吐 大便秘结 头重 头晕 口淡 畏寒 不寐 项强
角色0 ： 厚朴 苍术 藿香 陈皮 木瓜 草果 桔梗 枳壳 砂仁 大腹皮  角色1 ： 藿香 木瓜 香薷 广藿香 厚朴 紫苏叶 白扁豆 檀香 陈皮 乌药  角色2 ： 厚朴 陈皮 砂仁 苍术 藿香 草果 枳实 乳香 谷芽 法半夏  角色3 ： 木香 砂仁 陈皮 香附 枳壳 厚朴 草果 藿香 神曲 青蒿	腹痛 转筋 呕吐 恶心 腹泻 上吐下泻 胸闷 咳嗽 但热不寒 脱肛
角色0 ： 生姜 人参 半夏 茯苓 大枣 附子 干姜 枳实 白术 白矾  角色1 ： 半夏 生姜 厚朴 陈皮 干姜 吴茱萸 萝卜 大枣 五味子 大黄  角色2 ： 陈皮 白术 茯苓 半夏 人参 木香 枳壳 炙甘草 磁石 木瓜  角色3 ： 厚朴 生姜 枳实 陈皮 大枣 白术 白矾 川芎 紫苏子 木香	腹满 反胃 噎膈 心下痞 发狂 腹痛 月经过多 心烦 痫 腹泻
角色0 ： 茯苓 白术 半夏 人参 肉桂 大黄 藁本 白薇 青木香 五倍子  角色1 ： 半夏 茯苓 陈皮 白术 木香 甘草 枳实 香附 前胡 郁金  角色2 ： 甘草 人参 黄连 厚朴 附子 茯苓 橘红 地龙 半夏 天南星  角色3 ： 陈皮 白术 半夏 苍术 生姜 瓜蒌 桔梗 乌梅 红花 枳壳	呕吐 恶心 耳聋 噎膈 脱肛 腹痛 心下痞 腹满 咽干 少气
角色0 ： 薄荷 荷叶 荆芥 桔梗 冰片 麻黄 藿香 犀角 知母 当归  角色1 ： 荆芥 薄荷 甘草 川芎 桔梗 白芷 干姜 柴胡 苍术 阿胶  角色2 ： 川芎 荆芥 薄荷 细辛 白芷 苍术 藁本 樟脑 黄连 枳壳  角色3 ： 防风 细辛 白芷 荆芥 芍药 连翘 大黄 薤白 木通 秦艽	鼻塞 头痛 牙痛 头昏 腰痛 牙龈肿痛 心下痞 四肢拘急 粉刺 小儿脐突
角色0 ： 川乌 草乌 乌头 白芷 麻黄 苍术 五灵脂 麝香 附子 肉桂  角色1 ： 牛膝 木瓜 威灵仙 红花 桂枝 秦艽 续断 桑枝 马钱 马钱子  角色2 ： 乳香 没药 地龙 五灵脂 骨碎补 木鳖子 虎骨 自然铜 草乌 血竭  角色3 ： 乌头 川乌 草乌 何首乌 白芷 细辛 硫黄 樟脑 两头尖 制川乌	半身不遂 瘫痪 骨痛 四肢麻木 关节疼痛 背冷 口苦 足颤 脱肛 头痛
角色0 ： 川芎 白芷 细辛 羌活 防风 麻黄 茯苓 人参 石膏 天麻  角色1 ： 白芷 细辛 川芎 藁本 苍术 蔓荆子 白石英 菊花 泽兰 龙齿  角色2 ： 防风 羌活 独活 麻黄 荆芥 秦艽 生姜 槐花 龙骨 藁本  角色3 ： 细辛 白芷 防风 藁本 羌活 蔓荆子 木瓜 香附 阿魏 牛膝	头痛 鼻塞 恶风 呵欠 偏头痛 胃痛 目昏 腰痛 半身不遂 腹满
角色0 ： 附子 人参 白术 防风 藿香 麻黄 橘红 乌梅 苦参 竹沥  角色1 ： 甘草 白术 干姜 当归 茯苓 炙甘草 牛膝 牛胆 山楂 柴胡  角色2 ： 干姜 附子 肉桂 木香 山药 当归 高良姜 郁金 寒水石 威灵仙  角色3 ： 白术 木香 茯苓 人参 乌梅 炙甘草 诃子 当归 桔梗 苍术	腹痛 目昏 痫 面色青 气喘 消瘦 寒战 恶寒 干呕 头重
角色0 ： 五加 五加皮 牛膝 薏苡仁 独活 羚羊角 酸枣仁 海桐皮 丹参 防己  角色1 ： 防风 独活 羌活 细辛 羚羊角 麻黄 附子 荆芥 犀角 丹参  角色2 ： 麻黄 防风 独活 羌活 细辛 防己 附子 虎骨 干姜 川芎  角色3 ： 防风 独活 防己 秦艽 羌活 羚羊角 升麻 大腹皮 滑石 前胡	口噤 项强 舌强 角弓反张 四肢拘急 恶心 头摇 神昏 壮热 小便黄赤
角色0 ： 当归 延胡索 蒲黄 肉桂 牛膝 五灵脂 红花 丹参 琥珀 刘寄奴  角色1 ： 当归 川芎 红花 泽兰 益母草 五灵脂 丹参 青皮 黄芩 桃仁  角色2 ： 桃 桃仁 水蛭 虻虫 干漆 泽兰 陈皮 枳实 党参 益智  角色3 ： 当归 红花 赤芍 苏木 丹参 益母草 白芷 地龙 炮姜 鸡子	腹痛 难产 恶露不下 胞衣不下 带状疱疹 闭经 头晕 产后血崩 肠鸣 舌光
角色0 ： 大黄 黄连 苦参 升麻 栀子 附子 蜂房 青皮 穿山甲 巴豆  角色1 ： 大黄 黄柏 黄芩 甘草 黄连 赤小豆 穿山甲 连翘 皂荚 青黛  角色2 ： 连翘 白蔹 白及 玄参 海藻 昆布 夏枯草 五倍子 漏芦 射干  角色3 ： 巴豆 皂荚 白矾 猪牙皂 斑蝥 麝香 黄柏 当归 黄芩 泽泻	瘰疬 头痛 小儿口疮 耳聋 粉刺 头昏 乳房胀痛 痫 牙痛 嗳气
角色0 ： 木通 滑石 瞿麦 冬葵 冬葵子 石韦 通草 赤小豆 白茅根 枳实  角色1 ： 木通 滑石 大黄 瞿麦 桔梗 赤芍 泽泻 石榴 厚朴 白茅根  角色2 ： 车前 车前子 冬瓜 百部 莲子 延胡索 天竺黄 覆盆子 竹叶 梨  角色3 ： 泽泻 猪苓 木通 滑石 苍术 细辛 荆芥 巴戟天 冬葵 姜黄	小便不通 小便不利 尿血 小便黄赤 不寐 妊娠小便不通 便血 目昏 目干涩 尿痛
角色0 ： 生地黄 麦门冬 天门冬 知母 熟地黄 山药 犀角 梨 当归 葱白  角色1 ： 黄柏 黄连 黄芩 栀子 陈皮 柴胡 甘草 沉香 郁金 秦艽  角色2 ： 黄柏 生地黄 知母 黄连 黄芩 甘草 天门冬 栀子 蒲黄 前胡  角色3 ： 生地黄 黄连 黄芩 竹茹 黄柏 芍药 侧柏叶 连翘 槐花 莲子	吐血 鼻衄 咳血 便血 谵语 骨痛 大便下血 崩中 小儿遗尿 面色白
角色0 ： 麦冬 沙参 丹参 玄参 北沙参 天冬 玉竹 南沙参 白鲜皮 太子参  角色1 ： 桑 女贞 女贞子 桑叶 何首乌 桑椹 墨旱莲 桑椹子 熟地黄 黑芝麻  角色2 ： 麦冬 玄参 天花粉 薄荷 桔梗 菊花 白芍 绿豆 蝉蜕 远志  角色3 ： 麦冬 知母 天冬 甘草 山药 天花粉 大黄 款冬花 续断 梨	口渴 咽干 头晕 脱发 须发早白 潮热 不寐 浮肿 赤脉传睛 项强
角色0 ： 半夏 陈皮 枳实 茯苓 大腹皮 藿香 乌梅 香附 槟榔 白矾  角色1 ： 生姜 厚朴 干姜 附子 硫黄 麝香 陈皮 细辛 大黄 枳壳  角色2 ： 半夏 茯苓 白术 厚朴 枳壳 鹿茸 葱白 肉桂 川芎 附子  角色3 ： 半夏 陈皮 茯苓 甘草 白芷 郁金 桂枝 韭菜 薄荷 生姜	呕吐 恶心 寒战 大便下血 鼻干 背痛 腹满 肥胖 腹痛 胞衣不下
角色0 ： 朱砂 雄黄 麝香 牛黄 天竺黄 蟾酥 蜈蚣 钩藤 马勃 砂仁  角色1 ： 麝香 朱砂 雄黄 牛黄 天麻 冰片 青礞石 半夏 滑石 葫芦  角色2 ： 僵蚕 天麻 全蝎 天竺黄 胆南星 钩藤 琥珀 牛胆 蝉蜕 冰片  角色3 ： 全蝎 僵蚕 蜈蚣 天麻 麝香 天南星 朱砂 雄黄 牛胆 沉香	慢惊 痫 急惊 四肢抽搐 呵欠 发黄 小儿呕吐 腰膝无力 便血 寒战
角色0 ： 竹叶 淡竹 淡竹叶 连翘 薄荷 淡豆豉 桑叶 三七 菊花 大青叶  角色1 ： 石膏 甘草 黄芩 葛根 知母 黄柏 茯苓 通草 茜草 川芎  角色2 ： 石膏 知母 升麻 寒水石 栀子 薄荷 朱砂 麦冬 黄芩 防风  角色3 ： 甘草 黄芩 石膏 木通 黄柏 葱白 半夏 寒水石 党参 艾叶	头痛 口渴 烦躁 不寐 鼻衄 四肢拘急 肠鸣 咽肿 鼻干 鼻痛
角色0 ： 山药 鹿角 熟地黄 鹿角胶 枸杞子 菟丝子 牛膝 鹿角霜 肉苁蓉 续断  角色1 ： 五味子 山茱萸 石斛 磁石 巴戟天 牛膝 泽泻 肉苁蓉 远志 丹参  角色2 ： 牛膝 杜仲 菟丝子 山茱萸 肉苁蓉 石斛 柏子仁 远志 枸杞子 续断  角色3 ： 鹿茸 菟丝子 肉苁蓉 蛇床子 补骨脂 覆盆子 阳起石 韭子 巴戟天 五味子	耳聋 头晕 不孕 小便频数 盗汗 头昏 腰膝无力 腰重 消瘦 腰脊痛
角色0 ： 桔梗 甘草 生姜 枳壳 陈皮 前胡 茯苓 麦门冬 葛根 竹茹  角色1 ： 半夏 甘草 生姜 枳壳 附子 竹沥 郁金 青皮 葛根 大黄  角色2 ： 甘草 人参 茯苓 前胡 白术 竹茹 紫菀 郁金 吴茱萸 大枣  角色3 ： 枇杷叶 枇杷 竹茹 芦根 麦门冬 知母 桔梗 陈皮 肉桂 天麻	咳嗽 干呕 头昏 神昏 鼻衄 四肢疼痛 恶寒 喉痒 鼻干 头痛
角色0 ： 枳壳 桔梗 前胡 半夏 桑 知母 栀子 防风 柴胡 茯苓  角色1 ： 桔梗 枳壳 前胡 甘草 赤芍 干姜 葛根 轻粉 防风 白石英  角色2 ： 甘草 半夏 枳壳 茯苓 前胡 赤芍 硫黄 白矾 大豆 五倍子  角色3 ： 前胡 甘草 桔梗 旋覆花 生姜 半夏 橘红 苍术 枳实 紫菀	咳嗽 头痛 舌苔白 多唾 瘰疬 难产 角弓反张 鼻塞 口臭 恶风
角色0 ： 犀角 麦门冬 羚羊角 升麻 甘草 龙齿 白鲜皮 白茅根 五味子 浮萍  角色1 ： 升麻 玄参 射干 犀角 寒水石 羚羊角 大黄 知母 沙参 百合  角色2 ： 麦门冬 犀角 升麻 黄连 川贝母 知母 芍药 大枣 黄芩 党参  角色3 ： 栀子 犀角 升麻 石膏 黄芩 知母 柴胡 寒水石 地骨皮 绿豆	烦躁 壮热 舌肿 咽喉痛 咽干 血精 乳汁不行 头胀 经行腹痛 食欲不振
角色0 ： 甘草 麦门冬 柴胡 茯苓 苍术 五味子 半夏 人参 白术 雄黄  角色1 ： 甘草 人参 白术 细辛 百草霜 葛根 石膏 黄连 羌活 黄芪  角色2 ： 茯苓 甘草 半夏 白术 干姜 雄黄 人参 羚羊角 麦冬 香附  角色3 ： 当归 人参 白芍 茯苓 芍药 苍术 陈皮 砂仁 白术 黄连	烦躁 头痛 身重 阴疮 口淡 吐血 弄舌 身痛 湿疮 背痛
角色0 ： 人参 麦门冬 五味子 甘草 远志 麻黄 芍药 麝香 木香 白术  角色1 ： 甘草 麦门冬 人参 附子 当归 五味子 芍药 桔梗 天门冬 大枣  角色2 ： 人参 茯苓 五味子 白术 麦门冬 泽泻 射干 山茱萸 犀角 白石英  角色3 ： 大枣 生姜 小麦 甘草 吴茱萸 浮小麦 半夏 石斛 白术 藿香	短气 少气 自汗 背痛 面色青 谵语 盗汗 但热不寒 头痛 舌疮
角色0 ： 牛蒡 牛蒡子 荆芥 连翘 桔梗 大青叶 山豆根 淡豆豉 人中黄 薄荷  角色1 ： 金银花 连翘 天花粉 土茯苓 板蓝根 白鲜皮 玄参 蒲公英 皂角刺 木通  角色2 ： 薄荷 连翘 桔梗 荆芥 玄参 麻黄 黄柏 柏子仁 地龙 鸡内金  角色3 ： 连翘 荆芥 蝉蜕 防风 紫草 薄荷 木通 浮萍 苍术 栀子	麻疹 丹毒 杨梅疮 鼻塞 痄腮 口渴 咽肿 小儿丹毒 牙痛 咽干
角色0 ： 天麻 僵蚕 白附子 全蝎 天南星 附子 生姜 蜈蚣 肉桂 青黛  角色1 ： 天南星 白附子 附子 天麻 僵蚕 麝香 当归 巴戟天 枳壳 蝉蜕  角色2 ： 附子 益智 益智仁 麝香 延胡索 冬瓜 硫黄 天南星 穿山甲 檀香  角色3 ： 附子 白附子 天麻 天南星 僵蚕 麝香 全蝎 白术 硼砂 玄明粉	慢惊 神昏 口噤 急惊 角弓反张 肠鸣 四肢强直 小便黄赤 半身不遂 但热不寒
角色0 ： 苍术 川芎 白芷 羌活 桔梗 防风 半夏 炙甘草 黄柏 荆芥  角色1 ： 防风 羌活 独活 细辛 苍术 干姜 五味子 吴茱萸 薄荷 荆芥  角色2 ： 川芎 白芷 防风 羌活 桔梗 枳壳 牛膝 贯众 猪苓 阿胶  角色3 ： 防风 羌活 荆芥 甘草 白芷 川芎 秦艽 细辛 独活 麻黄	恶寒 恶寒发热 身痛 无汗 头重 咳嗽 目昏 耳聋 四肢拘急 口苦
角色0 ： 黄芩 人参 甘草 麦门冬 柴胡 知母 茯苓 金银花 寒水石 麻黄  角色1 ： 甘草 人参 炙甘草 升麻 茯苓 石膏 栀子 郁金 知母 黄芩  角色2 ： 甘草 人参 当归 白芍 芍药 黄芩 地骨皮 陈皮 干姜 炙甘草  角色3 ： 甘草 柴胡 炙甘草 乌梅 郁金 天门冬 白芍 五味子 木香 滑石	舌干 口苦 咽干 壮热 盗汗 胸痛 口臭 咳嗽 舌卷 腹痛
角色0 ： 甘草 人参 茯苓 桑 天门冬 川芎 三七 巴豆 竹沥 酸枣仁  角色1 ： 吴茱萸 附子 干姜 细辛 生姜 硫黄 香附 桑 艾叶 神曲  角色2 ： 干姜 人参 白术 厚朴 茯苓 大豆 草果 防风 全蝎 青蒿  角色3 ： 干姜 附子 吴茱萸 厚朴 白术 泽泻 栀子 杏仁 硫黄 薄荷	腹痛 背痛 腹满 面色青 恶风 鼻干 胁痛 咽喉痛 杨梅疮 自汗
角色0 ： 桔梗 枳壳 前胡 橘红 乌梅 大黄 柴胡 厚朴 山茱萸 桂枝  角色1 ： 茯苓 枳壳 半夏 前胡 黄连 黄柏 秦艽 槟榔 蒲公英 厚朴  角色2 ： 甘草 桔梗 枳壳 柴胡 茯苓 五味子 苍术 陈皮 当归 吴茱萸  角色3 ： 甘草 枳壳 半夏 桔梗 前胡 黄芩 香附 橘红 乌药 秦艽	咳嗽 寒热往来 头痛 脱肛 恶寒 盗汗 身痛 粉刺 胸痛 小便不利
角色0 ： 大黄 黄连 郁金 黄柏 栀子 龙胆 黄芩 地骨皮 玄参 柴胡  角色1 ： 黄芩 大黄 栀子 甘草 滑石 吴茱萸 黄柏 川芎 生地黄 白芷  角色2 ： 茵陈 大黄 栀子 龙胆 茵陈蒿 荷叶 黄柏 玄明粉 赤小豆 竹沥  角色3 ： 黄芩 枳实 大黄 黄连 柴胡 升麻 莱菔子 铅丹 石斛 青礞石	发黄 大便秘结 谵语 发狂 舌苔黄 小便黄赤 舌苔黄腻 腰痛 黄汗 小便不利
角色0 ： 杏 杏仁 葶苈子 皂荚 巴豆 桑白皮 百草霜 桂皮 荷叶 竹茹  角色1 ： 紫菀 款冬花 五味子 百部 天门冬 白前 桑 白芍 天花粉 白石英  角色2 ： 紫菀 百合 款冬花 桑 百部 马兜铃 白前 蛤蚧 阿胶 防己  角色3 ： 杏仁 杏 马兜铃 硼砂 樟脑 蛤蚧 三七 细辛 百草霜 大黄	咳嗽 上吐下泻 湿疮 发狂 项强 妊娠咳嗽 四肢麻木 难产 半身不遂 腹中痞块
角色0 ： 赤石脂 龙骨 禹余粮 紫石英 牡蛎 鹿茸 白薇 卷柏 荷叶 芍药  角色1 ： 牡蛎 龙骨 桑螵蛸 麻黄根 龟甲 白矾 琥珀 黄芩 党参 海螵蛸  角色2 ： 地榆 阿胶 艾叶 石榴 石榴皮 小蓟 槐花 赤石脂 陈皮 芍药  角色3 ： 当归 蒲黄 白芍 龙骨 茯苓 柴胡 乌梅 槐角 丹参 干姜	崩中 漏下 崩漏 脱肛 便血 遗尿 大便下血 小儿遗尿 烦躁 壮热
角色0 ： 远志 石菖蒲 酸枣仁 柏子仁 龙齿 五味子 琥珀 紫石英 乌头 朱砂  角色1 ： 党参 黄芪 山药 丹参 远志 三七 龙眼 麦冬 龙眼肉 玉竹  角色2 ： 远志 五味子 石菖蒲 酸枣仁 丹参 柏子仁 山药 青黛 防风 枸杞子  角色3 ： 熟地黄 何首乌 枸杞子 淫羊藿 黄精 制何首乌 黄芪 金樱子 锁阳 狗脊	心悸 健忘 头晕 多梦 胸闷 疲乏 食欲不振 须发早白 少气 心烦
角色0 ： 三棱 莪术 青皮 槟榔 姜黄 草果 神曲 萝卜 香附 三七  角色1 ： 木香 槟榔 青皮 香附 陈皮 枳壳 萝卜 半夏 干漆 丁香  角色2 ： 木香 槟榔 青皮 枳壳 砂仁 白芷 陈皮 草果 龙胆 硼砂  角色3 ： 三棱 莪术 巴豆 青皮 干漆 牵牛 五灵脂 槟榔 苍术 郁金	呕吐 积滞 恶心 吞酸 腹痛 胃痛 嘈杂 小便不通 手足厥冷 小儿腹痛
角色0 ： 川芎 香附 白芍 当归 白薇 茯苓 柴胡 陈皮 延胡索 熟地黄  角色1 ： 香附 乌药 川芎 益母草 砂仁 沉香 橘红 五灵脂 半夏 黄连  角色2 ： 白芍 当归 川芎 熟地黄 肉桂 阿胶 陈皮 芍药 藁本 巴豆  角色3 ： 当归 白芍 川芎 茯苓 芍药 红花 砂仁 肉桂 天门冬 石菖蒲	白带 赤白带 气喘 小儿木舌 崩中 产后发热 咽喉痛 经行腹痛 天疱疮 关节疼痛
角色0 ： 甘草 黄芩 人参 大黄 龙胆 枳壳 桑寄生 麻黄 石膏 生姜  角色1 ： 芍药 赤芍 大黄 鸡子 干姜 麦门冬 羌活 当归 丁香 杜仲  角色2 ： 芍药 赤芍 葛根 木通 羚羊角 升麻 郁金 玄参 麻黄 桔梗  角色3 ： 黄芩 甘草 柴胡 石膏 麻黄 枳壳 细辛 升麻 花椒 三七	壮热 头痛 目昏 胸痛 漏下 阴痛 舌干 腰重 头重 咽喉痛
角色0 ： 鳖甲 柴胡 知母 青蒿 常山 竹叶 蜂房 枳壳 秦艽 羚羊角  角色1 ： 知母 地骨皮 柴胡 鳖甲 秦艽 甘草 银柴胡 羚羊角 常山 麦门冬  角色2 ： 柴胡 秦艽 鳖甲 甘草 升麻 大黄 石膏 麦门冬 地榆 枳实  角色3 ： 地骨皮 柴胡 麦门冬 鳖甲 知母 甘草 丹参 陈皮 乌梅 黄柏	潮热 盗汗 寒热往来 四肢疼痛 身痛 口渴 阴疮 鼻衄 小儿鹅口 舌肿
角色0 ： 石膏 麻黄 黄芩 葛根 前胡 大枣 升麻 枳壳 赤芍 葶苈子  角色1 ： 甘草 升麻 柴胡 黄芩 郁金 人参 葱白 玄参 竹茹 知母  角色2 ： 黄芩 大黄 栀子 柴胡 升麻 芍药 厚朴 麻黄 防风 黄柏  角色3 ： 石膏 葛根 知母 黄芩 栀子 赤芍 升麻 乌梅 厚朴 葡萄	壮热 头痛 小儿口疮 牙痛 呵欠 胎毒 潮热 言语错乱 足颤 反胃
角色0 ： 牡丹 牡丹皮 延胡索 姜黄 当归 大黄 连翘 山茱萸 芍药 蛇床子  角色1 ： 芍药 赤芍 犀角 郁金 延胡索 五倍子 白芷 木香 花椒 麦门冬  角色2 ： 芍药 赤芍 当归 神曲 地榆 白术 白薇 五味子 黄连 细辛  角色3 ： 芍药 当归 赤芍 大黄 丹参 白芍 刘寄奴 郁金 桑枝 蔓荆子	心烦 吐血 四肢疼痛 腹痛 鼻衄 便血 尿血 心下悸 消瘦 头晕
角色0 ： 杜仲 牛膝 续断 狗脊 石斛 桑寄生 补骨脂 泽泻 白术 全蝎  角色1 ： 杜仲 牛膝 续断 补骨脂 菟丝子 鹿茸 山药 木瓜 石斛 白薇  角色2 ： 肉桂 当归 茯苓 磁石 乌药 牛膝 白薇 桑寄生 三七 党参  角色3 ： 山药 芡实 薏苡仁 莲子 白扁豆 莲须 黄柏 党参 锁阳 五倍子	腰痛 白带 产后腰痛 小便频数 头重 胸闷 滑胎 鼻衄 腰膝无力 经行腹痛
角色0 ： 杏 杏仁 苦杏仁 紫苏子 紫苏叶 浙贝母 葶苈子 陈皮 磁石 桔梗  角色1 ： 乌梅 五味子 罂粟 罂粟壳 诃子 紫苏叶 白矾 炮姜 甘草 生地黄  角色2 ： 桔梗 枳壳 瓜蒌 半夏 陈皮 川芎 橘红 桑 何首乌 茯苓  角色3 ： 橘红 川贝母 半夏 瓜蒌 法半夏 桔梗 百部 化橘红 紫苏子 五味子	咳嗽 气喘 胸闷 咳痰 咽干 四肢疼痛 面痛 小便频数 小儿发热 小便清长
角色0 ： 当归 川芎 白芍 吴茱萸 厚朴 生姜 姜黄 泽兰 生地黄 桂枝  角色1 ： 当归 芍药 木香 白芍 苍术 五味子 桂枝 丹参 白术 柴胡  角色2 ： 当归 白芍 甘草 干姜 川芎 红花 香附 三七 陈皮 人参  角色3 ： 桃 桃仁 红花 核桃仁 陈皮 巴豆 桔梗 蝉蜕 土茯苓 佛手	腹痛 心烦 面色青 少腹痛 产后腹痛 粉刺 畏寒 胸痛 牙痛 偏头痛
