木香 丁香 豆蔻 沉香 茴香 肉豆蔻 诃子 砂仁 藿香 白豆蔻	腹痛 呕吐 恶心 肠鸣 反胃 吞酸 里急后重 腹冷 噎膈 转筋
当归 桃 桃仁 川芎 红花 丹参 香附 赤芍 延胡索 白芍	腹痛 胁痛 胸闷 难产 胸痛 恶露不下 胞衣不下 产后腹痛 少腹痛 闭经
茯苓 木通 泽泻 滑石 车前 车前子 猪苓 桑 大黄 防己	小便不利 浮肿 小便不通 难产 尿血 小便黄赤 肥胖 阴疮 妊娠小便不通 产后浮肿
人参 甘草 麦门冬 茯苓 远志 五味子 石菖蒲 酸枣仁 天门冬 生地黄	烦躁 心烦 短气 耳聋 少气 舌干 咽干 健忘 不寐 口苦
防风 羌活 细辛 独活 菊花 羚羊角 藜 附子 麻黄 蒺藜	目昏 口噤 项强 皮肤瘙痒 流泪 四肢拘急 舌强 角弓反张 远视 恶风
黄连 黄芩 大黄 黄柏 栀子 龙胆 胡黄连 青黛 芦荟 茵陈	烦躁 壮热 发黄 大便秘结 口臭 谵语 丹毒 发狂 舌肿 牙痛
甘草 麻黄 石膏 生姜 黄芩 桂枝 葛根 芍药 大枣 柴胡	头痛 恶寒 无汗 恶风 恶寒发热 身痛 项强 脏躁 胞衣不下 黄汗
麝香 乳香 没药 雄黄 冰片 轻粉 朱砂 白矾 血竭 巴豆	瘰疬 臁疮 无名肿毒 牙痛 杨梅疮 胎毒 湿疮 粉刺 口臭 小儿口疮
升麻 黄芩 石膏 犀角 甘草 栀子 大黄 麦门冬 葛根 知母	壮热 头痛 烦躁 鼻干 咽喉痛 舌干 丹毒 口中生疮 面色青 畏寒
杏 杏仁 桑 紫菀 麻黄 桑白皮 款冬花 五味子 百合 知母	咳嗽 气喘 喉痒 妊娠咳嗽 咽干 咳痰 发狂 噎膈 小儿发黄 小儿腹痛
桔梗 半夏 甘草 枳壳 前胡 橘红 茯苓 瓜蒌 陈皮 枇杷叶	咳嗽 气喘 胸闷 多唾 咳痰 噎膈 小儿发热 头重 寒热往来 干呕
干姜 附子 吴茱萸 白术 人参 厚朴 生姜 肉桂 细辛 硫黄	腹痛 短气 转筋 腹冷 手足厥冷 面色青 肠鸣 背痛 少气 腹满
朱砂 麝香 牛黄 僵蚕 天麻 白附子 天南星 全蝎 雄黄 附子	痫 慢惊 急惊 神昏 角弓反张 四肢抽搐 弄舌 小儿发热 四肢拘急 腹中痞块
当归 白芍 阿胶 川芎 龙骨 牡蛎 赤石脂 香附 艾叶 熟地黄	白带 赤白带 崩漏 胎动不安 崩中 漏下 胎漏 脱肛 不孕 滑胎
牛膝 川乌 当归 乌头 草乌 木瓜 防风 独活 杜仲 五加	腰痛 半身不遂 瘫痪 骨痛 四肢麻木 四肢疼痛 臂痛 关节疼痛 转筋 背痛
白芷 川芎 防风 细辛 荆芥 羌活 薄荷 苍术 藁本 桔梗	头痛 鼻塞 头昏 牙痛 身痛 偏头痛 恶风 呵欠 喷嚏 咳嗽
木香 槟榔 大黄 三棱 巴豆 莪术 青皮 牵牛 枳壳 郁李	腹痛 浮肿 积滞 里急后重 腹满 疳积 消瘦 气喘 大便秘结 胸闷
半夏 甘草 生姜 茯苓 人参 厚朴 白术 陈皮 枳实 竹茹	呕吐 恶心 干呕 呃逆 心下痞 反胃 小儿呕吐 腹满 妊娠呕吐 舌疮
连翘 麦冬 薄荷 玄参 桔梗 荆芥 牛蒡 竹叶 天花粉 牛蒡子	口渴 麻疹 咽干 烦躁 谵语 发狂 神昏 咳嗽 丹毒 杨梅疮
柴胡 甘草 黄芩 知母 鳖甲 地骨皮 芍药 赤芍 枳壳 秦艽	心烦 潮热 口苦 寒热往来 五心烦热 舌干 盗汗 四肢疼痛 咽干 但热不寒
甘草 人参 茯苓 白术 当归 白芍 麦冬 炙甘草 芍药 乌梅	自汗 盗汗 潮热 心烦 恶风 消瘦 口渴 神昏 寒战 弄舌
甘草 白术 茯苓 人参 陈皮 山药 炙甘草 肉桂 半夏 党参	恶寒 腹满 身重 脱肛 头痛 消瘦 舌苔白 头重 大便溏 畏寒
陈皮 厚朴 香附 神曲 砂仁 苍术 山楂 青皮 麦芽 藿香	呕吐 吞酸 腹痛 恶心 嘈杂 嗳气 食欲不振 噎膈 胃痛 腹泻
当归 芍药 赤芍 甘草 牡丹 生地黄 白芍 牡丹皮 蒲黄 阿胶	吐血 鼻衄 便血 大便下血 咳血 尿血 头晕 头重 月经过多 不孕
山药 菟丝子 杜仲 五味子 山茱萸 牛膝 肉苁蓉 熟地黄 枸杞子 鹿茸	头晕 心悸 健忘 耳聋 腰痛 小便频数 盗汗 遗尿 多梦 不孕
