芍药 当归 牡丹 牡丹皮 生地黄 赤芍 延胡索 蒲黄 白薇 牛膝	吐血 鼻衄 胞衣不下 潮热 崩中 恶寒 牙痛 胸痛 壮热 干呕
厚朴 苍术 藿香 陈皮 砂仁 木瓜 香薷 半夏 草果 广藿香	呕吐 恶心 转筋 头痛 胸闷 上吐下泻 腹泻 身重 腹痛 呃逆
麝香 朱砂 雄黄 牛黄 白矾 蟾酥 轻粉 巴豆 蜈蚣 青黛	痫 慢惊 急惊 无名肿毒 咽干 舌肿 项强 舌疮 产后发热 天疱疮
牛蒡 藜 荆芥 连翘 牛蒡子 蒺藜 苦参 蝉蜕 紫草 海藻	瘰疬 麻疹 皮肤瘙痒 丹毒 咳嗽 小儿丹毒 头痛 痄腮 恶心 喷嚏
阿胶 地榆 蒲黄 当归 赭石 三七 槐花 乌梅 石榴 艾叶	吐血 便血 崩漏 尿血 脱肛 鼻衄 白带 腹痛 咳血 头痛
升麻 犀角 大黄 羚羊角 玄参 钩藤 石膏 龙齿 蛇蜕 射干	壮热 痫 发狂 咽喉痛 鼻衄 咽肿 舌肿 神昏 头痛 喷嚏
柴胡 鳖甲 知母 地骨皮 秦艽 青蒿 芍药 枳壳 常山 犀角	潮热 盗汗 寒热往来 消瘦 但热不寒 鼻干 无汗 壮热 黄汗 目昏
茴香 木香 附子 肉桂 干姜 吴茱萸 小茴香 硫黄 川楝子 沉香	腹痛 腹冷 呕吐 腰痛 咳嗽 胁痛 胸闷 烦躁 食欲不振 蟹睛
桑 桑白皮 桔梗 桑寄生 桑叶 五味子 紫菀 桑螵蛸 紫苏叶 桑枝	咳嗽 气喘 咽干 小便不利 口渴 鼻衄 遗尿 头痛 胸痛 崩漏
甘草 柴胡 黄芩 枳壳 桔梗 茯苓 大黄 白芍 知母 葛根	口苦 舌干 寒热往来 鼻干 胁痛 腹痛 足颤 恶心 小便黄赤 舌苔黄
青皮 三棱 木香 莪术 槟榔 陈皮 香附 姜黄 砂仁 乌药	恶心 呕吐 吞酸 积滞 寒热往来 头昏 臂痛 便血 胁痛 腹满
桃 桃仁 红花 当归 赤芍 泽兰 苏木 水蛭 丹参 虻虫	腹痛 胁痛 恶露不下 胸痛 大便秘结 反胃 少腹痛 咽干 胞衣不下 胎毒
远志 五味子 人参 石菖蒲 酸枣仁 柏子仁 茯苓 麦门冬 丹参 龙齿	健忘 心悸 耳聋 盗汗 不寐 自汗 多梦 痫 口渴 发狂
乳香 没药 轻粉 血竭 麝香 冰片 穿山甲 儿茶 蓖麻 白及	瘰疬 臁疮 无名肿毒 杨梅疮 湿疮 胞衣不下 胎毒 短气 干呕 潮热
当归 白芍 川芎 香附 乌药 熟地黄 益母草 白术 黄柏 肉桂	白带 赤白带 胎漏 产后浮肿 丹毒 赤脉传睛 胁痛 呕吐 湿疮 耳痛
半夏 生姜 厚朴 陈皮 枳实 茯苓 白芍 白蔹 滑石 苍术	呕吐 腹满 心下痞 恶寒 咳嗽 难产 面色青 小儿呕吐 寒战 发狂
甘草 茯苓 人参 白术 炙甘草 附子 细辛 百草霜 五味子 乌梅	短气 头昏 头重 腹满 自汗 鼻衄 恶风 背痛 身重 舌苔白
防风 菊花 羌活 细辛 蔓荆子 荆芥 羚羊角 木贼 石决明 决明子	目昏 流泪 头痛 拳毛倒睫 远视 胬肉攀睛 耳聋 鼻干 咽肿 滑胎
僵蚕 天麻 白附子 附子 全蝎 天南星 麝香 蜈蚣 蝉蜕 牛胆	慢惊 痫 急惊 口噤 角弓反张 神昏 头痛 瘰疬 头胀 偏头痛
茯苓 半夏 人参 甘草 白术 陈皮 干姜 生姜 川芎 黄柏	呕吐 恶心 气喘 小儿呕吐 头晕 口淡 项强 舌卷 神昏 恶寒
龙骨 牡蛎 当归 赤石脂 干姜 续断 白薇 禹余粮 鹿茸 白芍	盗汗 崩中 漏下 自汗 崩漏 脱肛 呵欠 心烦 痫 潮热
黄芩 黄连 大黄 黄柏 栀子 升麻 绿豆 防风 三七 甘草	烦躁 谵语 大便秘结 大便下血 吐血 牙痛 口渴 湿疮 发狂 粉刺
巴豆 大黄 牵牛 甘遂 牵牛子 芫花 皂荚 猪牙皂 大戟 五灵脂	浮肿 积滞 腹满 大便秘结 瘰疬 气喘 腰痛 痫 腹痛 小便不通
甘草 黄芩 升麻 石膏 柴胡 葛根 犀角 麦门冬 寒水石 枳壳	头痛 壮热 舌干 耳聋 腹满 鼻干 口渴 四肢拘急 口噤 弄舌
黄芩 栀子 大黄 黄连 茵陈 黄柏 郁金 龙胆 枳实 茵陈蒿	烦躁 发黄 谵语 小便黄赤 头汗 舌苔黄 舌苔黄腻 壮热 黄汗 舌疮
麦门冬 甘草 人参 生地黄 地骨皮 天门冬 茯苓 柴胡 枳壳 黄柏	烦躁 心烦 口苦 舌干 寒热往来 咽干 近视 牙痛 弄舌 神昏
防风 独活 麻黄 羌活 细辛 羚羊角 秦艽 防己 前胡 竹沥	口噤 项强 角弓反张 四肢拘急 恶风 舌强 言语错乱 四肢强直 神昏 头昏
芍药 赤芍 当归 柴胡 甘草 羚羊角 香附 大黄 橘红 葫芦	壮热 头痛 四肢疼痛 无汗 背痛 牙痛 咽干 寒战 目昏 阴疮
当归 白芍 芍药 甘草 川芎 白芷 香附 赭石 马齿苋 厚朴	腹痛 胁痛 耳聋 盗汗 产后腹痛 潮热 少腹痛 消瘦 便血 弄舌
杏 杏仁 苦杏仁 麻黄 紫苏子 葶苈子 射干 川贝母 百合 沙参	咳嗽 气喘 痫 耳聋 寒战 目羞明 崩漏 干呕 杨梅疮 腹泻
生姜 甘草 大枣 人参 半夏 竹茹 葱白 芦根 小麦 薤白	短气 干呕 鼻塞 头痛 心烦 恶寒 少气 自汗 小儿口疮 壮热
桔梗 甘草 枳壳 前胡 半夏 旋覆花 柴胡 大腹皮 秦艽 当归	咳嗽 头痛 鼻塞 目昏 恶心 舌干 喉痒 头重 浮肿 舌肿
木香 丁香 沉香 砂仁 藿香 檀香 甘松 香附 乌药 青木香	呕吐 腹痛 反胃 呃逆 噎膈 胃痛 口臭 腹泻 胸痛 胁痛
附子 干姜 吴茱萸 硫黄 细辛 皂荚 肉桂 阿胶 鳖甲 龙齿	手足厥冷 腹痛 面色青 转筋 背痛 少气 肠鸣 阴疮 腹满 恶寒
石膏 甘草 黄芩 知母 麻黄 葛根 寒水石 升麻 煅石膏 铅丹	头痛 壮热 谵语 自汗 小儿丹毒 神昏 气喘 畏寒 但热不寒 恶寒
茯苓 泽泻 防己 木通 郁李 郁李仁 猪苓 大腹皮 槟榔 薏苡仁	浮肿 小便不利 肥胖 瞳神散大 腰脊痛 阴挺 呃逆 身痛 妊娠呕吐 瘫痪
木通 滑石 车前 车前子 泽泻 瞿麦 猪苓 通草 冬葵 冬葵子	小便不通 小便不利 尿血 难产 腰重 痱子 小便黄赤 妊娠小便不通 嘈杂 远视
茯苓 甘草 人参 白术 炙甘草 肉桂 五味子 防己 川芎 防风	恶风 自汗 少气 恶寒 耳聋 身痛 口淡 牙痛 臂痛 小便不利
紫菀 款冬花 五味子 麦门冬 桔梗 百合 枇杷 枇杷叶 百部 天门冬	咳嗽 咳血 气喘 弄舌 盗汗 胁痛 心烦 咳痰 阴痒 经行腹痛
山药 白术 茯苓 肉桂 益智 益智仁 泽泻 炮姜 芡实 莲子	盗汗 自汗 畏寒 遗尿 小便频数 大便溏 目昏 小便不利 呕吐 瘰疬
黄连 青黛 胡黄连 芦荟 使君子 龙胆 芜荑 麝香 雷丸 熊胆	疳积 消瘦 口臭 腹痛 潮热 吐血 心烦 阴痒 盗汗 鼻痒
神曲 山楂 陈皮 麦芽 砂仁 香附 枳实 莱菔子 厚朴 苍术	吞酸 嘈杂 嗳气 积滞 食欲不振 胸闷 腹泻 恶心 腹满 呕吐
连翘 薄荷 竹叶 金银花 桔梗 天花粉 淡竹 荆芥 淡竹叶 板蓝根	头痛 口渴 丹毒 麻疹 烦躁 神昏 痄腮 恶寒 咳嗽 吐血
甘草 陈皮 乌梅 人参 茯苓 半夏 罂粟 枳壳 罂粟壳 诃子	咳嗽 脱肛 里急后重 潮热 大便下血 胎毒 小便不利 臂痛 呕吐 身重
牛膝 杜仲 菟丝子 肉苁蓉 山茱萸 石斛 鹿茸 五味子 磁石 补骨脂	腰痛 耳聋 头晕 不孕 小便频数 目昏 腰膝无力 腰重 少气 流泪
牛黄 朱砂 冰片 麝香 琥珀 雄黄 天竺黄 珍珠 硼砂 钩藤	痫 神昏 发狂 谵语 头晕 四肢抽搐 急惊 小儿发热 流泪 头痛
豆蔻 丁香 肉豆蔻 木香 白豆蔻 诃子 草豆蔻 高良姜 胡椒 沉香	呕吐 肠鸣 恶心 腹冷 吞酸 口淡 胸闷 反胃 嗳气 口臭
牛膝 杜仲 五加 木瓜 五加皮 续断 独活 芥子 白芥子 白芥	腰痛 杨梅疮 四肢麻木 骨痛 关节疼痛 半身不遂 胁痛 产后腰痛 足痛 肥胖
薄荷 白芷 荆芥 川芎 细辛 防风 荷叶 苍耳 桔梗 苍耳子	鼻塞 头痛 牙痛 头昏 胎毒 瘫痪 身痛 骨痛 舌卷 恶心
川芎 白芷 细辛 防风 羌活 藁本 苍术 独活 蔓荆子 白术	头痛 恶寒 身痛 偏头痛 鼻塞 腰脊痛 气喘 头昏 浮肿 头重
甘草 麻黄 桂枝 防风 羌活 苍术 葛根 白芷 葱白 马兜铃	恶寒 无汗 恶寒发热 项强 身痛 身重 舌苔白 神昏 胃痛 足痛
半夏 橘红 桔梗 前胡 瓜蒌 枳壳 川贝母 甘草 麻黄 法半夏	咳嗽 胸闷 气喘 呕吐 咳痰 胁痛 喉痒 短气 大便秘结 头痛
甘草 当归 白术 干姜 人参 附子 苦参 鸡子 五灵脂 白扁豆	腹痛 少气 身重 消瘦 心烦 头晕 气喘 足颤 多唾 产后腹痛
木香 枳壳 槟榔 陈皮 厚朴 青皮 大黄 青木香 苍术 甘草	腹痛 里急后重 难产 脱肛 胁痛 气喘 恶寒 妊娠咳嗽 积滞 大便溏
甘草 茯苓 人参 白术 白芍 当归 柴胡 石斛 生姜 黄芩	心烦 五心烦热 鼻衄 吐血 唇肿 赤白带 气喘 臂痛 丹毒 胁痛
川乌 乌头 草乌 附子 五灵脂 天麻 白芷 地龙 全蝎 天南星	半身不遂 瘫痪 骨痛 头痛 瘰疬 牙痛 浮肿 耳聋 腹冷 关节疼痛
白术 甘草 人参 茯苓 半夏 木香 三七 赤小豆 梅花 小茴香	自汗 呕吐 心烦 目昏 腹满 恶心 头痛 难产 牙痛 多唾
麦冬 玄参 知母 沙参 天冬 丹参 天花粉 桔梗 梨 北沙参	口渴 咽干 咳嗽 心烦 谵语 咽喉痛 半身不遂 口臭 口淡 舌强
当归 白芍 阿胶 川芎 艾叶 香附 白术 益母草 熟地黄 砂仁	腹痛 胎动不安 胎漏 不孕 难产 头昏 噎膈 经行腹痛 善怒 漏下
熟地黄 党参 山药 黄芪 鹿角 何首乌 枸杞子 丹参 女贞 菟丝子	头晕 心悸 健忘 食欲不振 疲乏 多梦 须发早白 崩漏 白带 脱发
