当归 桃 桃仁 红花 川芎 赤芍 白芍 香附 甘草 牛膝	腹痛 心烦 胁痛 头晕 产后腹痛 胞衣不下 难产 恶露不下 白带 闭经
枇杷 枇杷叶 竹叶 甘草 麦冬 淡竹 桔梗 淡竹叶 天冬 杏	咳嗽 口渴 咽干 吐血 气喘 烦躁 舌干 干呕 喉痒 咳痰
甘草 桔梗 升麻 柴胡 防风 陈皮 荆芥 黄芩 茯苓 前胡	恶寒 麻疹 壮热 头痛 鼻塞 恶寒发热 谵语 咳嗽 无汗 脱肛
川乌 乌头 乳香 没药 附子 天南星 草乌 当归 白芷 地龙	瘫痪 头痛 半身不遂 骨痛 浮肿 腰痛 牙痛 口噤 恶心 鼻塞
甘草 柴胡 茯苓 人参 白术 当归 川芎 白芍 半夏 黄芩	头痛 胁痛 口苦 潮热 寒热往来 心烦 咽干 难产 呕吐 自汗
豆蔻 人参 肉桂 甘草 白术 丁香 木香 附子 茯苓 肉豆蔻	呕吐 腹痛 恶心 肠鸣 吞酸 寒战 手足厥冷 腹冷 呃逆 反胃
芍药 赤芍 甘草 当归 柴胡 茯苓 人参 鳖甲 桑 枳壳	心烦 咳嗽 盗汗 潮热 四肢疼痛 烦躁 壮热 五心烦热 寒热往来 咽干
甘草 麦冬 黄芩 薄荷 黄连 栀子 连翘 桔梗 黄柏 玄参	口渴 烦躁 谵语 咽干 大便秘结 丹毒 舌干 发狂 口臭 鼻干
甘草 牡蛎 乌梅 葱白 当归 柴胡 麻黄 鳖甲 半夏 常山	盗汗 头痛 自汗 壮热 潮热 心烦 恶寒 寒热往来 头重 瘰疬
人参 附子 天麻 防风 白附子 远志 茯苓 甘草 羌活 僵蚕	痫 神昏 口噤 目昏 慢惊 健忘 四肢拘急 舌强 烦躁 角弓反张
前胡 甘草 半夏 人参 茯苓 生姜 枳壳 芥子 白芥 白芥子	头痛 目昏 心烦 短气 腹满 壮热 少气 多唾 咳嗽 干呕
阿胶 甘草 人参 桑 紫菀 杏 杏仁 款冬花 当归 五味子	咳嗽 腹痛 气喘 吐血 妊娠咳嗽 咽干 多唾 大便下血 短气 咳血
山药 茯苓 黄柏 当归 泽泻 人参 山茱萸 白芍 五味子 菟丝子	盗汗 腰痛 头晕 白带 自汗 耳聋 不孕 心烦 健忘 遗尿
麝香 轻粉 乳香 雄黄 黄连 没药 朱砂 冰片 血竭 熊胆	臁疮 壮热 瘰疬 无名肿毒 慢惊 湿疮 杨梅疮 白带 胎毒 疳积
麝香 朱砂 天南星 雄黄 附子 牛黄 白附子 半夏 僵蚕 天麻	慢惊 痫 急惊 神昏 口噤 角弓反张 壮热 手足厥冷 烦躁 胸闷
巴豆 木香 丁香 乳香 麝香 沉香 朱砂 杏 杏仁 豆蔻	腹痛 呕吐 痫 积滞 反胃 恶心 噎膈 浮肿 消瘦 吞酸
木香 槟榔 青皮 陈皮 三棱 甘草 莪术 牵牛 香附 枳壳	呕吐 恶心 吞酸 浮肿 腹痛 嘈杂 疳积 积滞 胃痛 嗳气
神曲 陈皮 黄连 山楂 甘草 麦芽 香附 半夏 白术 厚朴	呕吐 腹痛 吞酸 疳积 嘈杂 恶心 嗳气 积滞 潮热 口臭
竹茹 甘草 玄参 麦门冬 苦参 升麻 人参 黄芩 大黄 天门冬	瘰疬 吐血 干呕 呃逆 烦躁 壮热 咽喉痛 发狂 丹毒 恶寒
附子 干姜 白术 人参 甘草 当归 吴茱萸 茯苓 细辛 厚朴	腹痛 短气 少气 耳聋 恶风 手足厥冷 腹满 背痛 腰痛 腹冷
益智 益智仁 山药 茯苓 附子 甘草 木香 豆蔻 茴香 肉豆蔻	腹痛 肠鸣 小便频数 腹冷 腰痛 遗尿 白带 自汗 腹泻 盗汗
杏仁 杏 甘草 细辛 麻黄 防风 茯苓 人参 半夏 干姜	咳嗽 口噤 短气 鼻塞 角弓反张 恶寒 项强 恶风 气喘 舌强
桑 桑寄生 当归 牛膝 防风 杜仲 独活 甘草 苍术 木瓜	腰痛 四肢麻木 半身不遂 腹痛 骨痛 瘫痪 身痛 关节疼痛 臂痛 头昏
桑 牵牛 茯苓 甘草 半夏 牵牛子 杏 杏仁 槟榔 防己	咳嗽 浮肿 气喘 小便不利 小便不通 腹满 鼻塞 咳痰 烦躁 腰重
木香 豆蔻 甘草 草豆蔻 厚朴 沉香 茯苓 白术 生姜 高良姜	腹痛 呕吐 转筋 恶心 肠鸣 面色青 上吐下泻 腹满 头痛 腹冷
人参 茯苓 五味子 当归 五加 五加皮 牛膝 远志 鹿茸 柏子仁	健忘 耳聋 腰痛 盗汗 心烦 目昏 浮肿 心悸 四肢疼痛 小便频数
甘草 人参 茯苓 白术 半夏 陈皮 厚朴 干姜 当归 生姜	呕吐 恶心 短气 自汗 干呕 少气 心下痞 腹满 口淡 身重
大黄 当归 黄连 郁金 木香 槟榔 黄芩 甘草 枳壳 青皮	腹痛 里急后重 瘰疬 无名肿毒 积滞 大便秘结 呕吐 舌苔黄 胃痛 臁疮
甘草 石膏 茴香 知母 人参 当归 蒲黄 黄芩 小茴香 滑石	吐血 鼻衄 便血 尿血 痫 崩漏 腹冷 咳血 壮热 崩中
沙参 麦冬 桑 桑叶 甘草 薄荷 丹参 北沙参 连翘 杏	胸闷 口渴 咳嗽 心悸 咽干 头痛 胸痛 头晕 恶寒 食欲不振
牛蒡 牛蒡子 甘草 荆芥 防风 连翘 当归 金银花 桔梗 薄荷	头痛 杨梅疮 咳嗽 麻疹 鼻塞 丹毒 烦躁 壮热 恶寒 口渴
车前 车前子 泽泻 木通 甘草 茯苓 滑石 猪苓 黄芩 茵陈	小便不通 小便不利 发黄 口渴 尿血 浮肿 烦躁 难产 小便黄赤 黄汗
防风 黄芩 菊花 甘草 连翘 当归 羌活 大黄 荆芥 川芎	目昏 瘰疬 流泪 大便秘结 远视 舌干 阴疮 恶心 无名肿毒 胬肉攀睛
当归 川芎 白芍 甘草 杜仲 熟地黄 白术 香附 芍药 阿胶	腹痛 白带 胎动不安 赤白带 腰痛 崩漏 胎漏 不孕 面色青 头晕
郁李 郁李仁 巴豆 皂荚 大黄 槟榔 附子 蜈蚣 斑蝥 藜	瘰疬 浮肿 腹满 小便不利 气喘 小便不通 小儿口疮 耳聋 短气 白带
薄荷 防风 甘草 僵蚕 陈皮 羌活 藿香 白芷 朱砂 钩藤	咳嗽 呕吐 腹痛 急惊 头痛 气喘 烦躁 腹泻 无名肿毒 转筋
藜 蒺藜 当归 升麻 白芷 附子 防风 甘草 木香 羌活	耳聋 口臭 皮肤瘙痒 自汗 瘰疬 腹满 牙痛 腹痛 白带 粉刺
牡丹 牡丹皮 生地黄 当归 甘草 柴胡 芍药 白芍 黄连 知母	潮热 心烦 咳嗽 吐血 头痛 烦躁 盗汗 恶寒 鼻塞 口苦
川芎 细辛 防风 白芷 甘草 荆芥 羌活 薄荷 天麻 当归	头痛 鼻塞 牙痛 头昏 偏头痛 目昏 半身不遂 皮肤瘙痒 耳聋 头重
当归 芍药 龙骨 干姜 赤石脂 桃 附子 禹余粮 乳香 人参	崩中 漏下 白带 赤白带 腹痛 崩漏 心烦 吐血 难产 恶露不下
甘草 芍药 桂枝 防风 白芍 羌活 麻黄 当归 生姜 川芎	恶寒 无汗 恶风 自汗 头痛 项强 身痛 身重 恶寒发热 呵欠
牛黄 甘草 龙胆 犀角 大黄 黄芩 黄连 朱砂 钩藤 麝香	痫 烦躁 壮热 神昏 谵语 发狂 口苦 舌干 大便秘结 头晕
党参 当归 黄芪 甘草 地榆 白芍 女贞 白术 女贞子 茯苓	头晕 心悸 便血 健忘 食欲不振 疲乏 多梦 脱肛 头昏 大便下血
桃 桃仁 杏仁 杏 甘草 罂粟 罂粟壳 茯苓 人参 当归	咳嗽 气喘 腹痛 里急后重 脱肛 发狂 短气 大便秘结 烦躁 咽干
甘草 麦门冬 黄芩 升麻 石膏 芍药 杏 杏仁 赤芍 柴胡	壮热 头痛 烦躁 咳嗽 舌干 心烦 鼻干 四肢疼痛 谵语 吐血
